GEOID,state.name,county.name,totalpop,medincome,medage,education.total,education.bachelors,education.gradprofess,mortgage.total,mortgage.40to49pct,mortgage.50pctplus,healthins.male.18to24.total,healthins.male.18to24.coverage,healthins.male.18to24.nocoverage,healthins.female.18to24.total,healthins.female.18to24.coverage,healthins.female.18to24.nocoverage,healthins.male.25to34.total,healthins.male.25to34.coverage,healthins.male.25to34.nocoverage,healthins.female.25to34.total,healthins.female.25to34.coverage,healthins.female.25to34.nocoverage,pct.ed.collegegrad,pct.mortgage40plus,pct.mortgage50plus
01099,Alabama,Monroe County,21745,26036,41.7,14794,1079,764,5006,207,394,985,703,282,727,565,162,870,538,332,1102,780,322,12.458,12.006,7.871
01079,Alabama,Lawrence County,33288,43779,42,23370,1671,709,10443,383,688,1186,1002,184,1417,1243,174,1864,1314,550,1675,1260,415,10.184,10.256,6.588
01081,Alabama,Lee County,156597,47564,31,92452,18261,13961,34932,1028,1771,14610,12408,2202,14349,12780,1569,9247,7439,1808,9725,8136,1589,34.853,8.013,5.07
01093,Alabama,Marion County,30058,35719,44.1,21406,1784,1094,9421,222,444,1245,905,340,1201,946,255,1410,1111,299,1423,1194,229,13.445,7.069,4.713
01107,Alabama,Pickens County,20170,36220,42.1,14241,1248,431,5615,82,228,871,592,279,760,582,178,1052,862,190,874,659,215,11.79,5.521,4.061
01119,Alabama,Sumter County,13084,21663,35.9,8244,872,630,3274,97,251,1172,670,502,1277,924,353,402,350,52,611,411,200,18.219,10.629,7.666
01073,Alabama,Jefferson County,659460,49321,37.6,447048,86862,55817,164199,5480,11953,30350,23563,6787,30724,25344,5380,39157,29430,9727,44697,37904,6793,31.916,10.617,7.28
01023,Alabama,Choctaw County,13188,32122,45.8,9449,745,355,4379,49,141,514,342,172,461,301,160,545,393,152,653,557,96,11.641,4.339,3.22
01059,Alabama,Franklin County,31507,39501,37.7,20734,1722,1056,7942,114,366,1723,1266,457,1410,947,463,1768,1429,339,1590,1233,357,13.398,6.044,4.608
01091,Alabama,Marengo County,19743,32255,42.1,13557,1315,774,5689,292,344,788,477,311,592,397,195,1007,638,369,1132,991,141,15.409,11.179,6.047
01113,Alabama,Russell County,58480,38988,35.3,38710,4092,2444,13368,584,845,2493,1644,849,2599,1816,783,3515,2534,981,4120,3312,808,16.885,10.69,6.321
01019,Alabama,Cherokee County,25855,40041,46.1,18797,1237,1107,8435,230,343,1049,809,240,914,678,236,983,862,121,1109,952,157,12.47,6.793,4.066
01039,Alabama,Covington County,37519,39467,43.4,26416,2740,1359,11476,313,586,1448,800,648,1397,995,402,1803,1493,310,1969,1622,347,15.517,7.834,5.106
01041,Alabama,Crenshaw County,13866,38937,41.4,9588,1143,419,3805,94,206,655,459,196,544,428,116,558,378,180,677,532,145,16.291,7.884,5.414
01047,Alabama,Dallas County,40755,30065,39.3,26849,2181,1628,9755,286,556,1785,1058,727,1913,1382,531,1963,1364,599,2294,1727,567,14.187,8.631,5.7
01077,Alabama,Lauderdale County,92590,44888,41.5,63168,8710,5520,26430,643,1382,5131,4037,1094,5729,4878,851,4594,3355,1239,4659,3450,1209,22.527,7.662,5.229
01085,Alabama,Lowndes County,10362,29785,40.7,7065,671,300,3163,106,213,456,382,74,473,363,110,538,390,148,587,573,14,13.744,10.085,6.734
01087,Alabama,Macon County,19358,32308,38,12280,1332,1134,5079,109,366,1452,1284,168,1745,1619,126,931,555,376,920,776,144,20.081,9.352,7.206
01083,Alabama,Limestone County,91695,52831,39.1,63026,10410,5084,24979,666,1146,3467,2395,1072,3422,2786,636,5039,3420,1619,5265,4128,1137,24.584,7.254,4.588
01117,Alabama,Shelby County,208721,74063,38.5,141263,39369,20290,61189,1660,3726,8269,6888,1381,8165,7122,1043,11102,8927,2175,12477,10999,1478,42.233,8.802,6.089
01115,Alabama,St. Clair County,86937,53483,40.1,60248,6366,3277,26116,787,1554,3465,2823,642,3410,2608,802,4433,3856,577,4773,4201,572,16.006,8.964,5.95
01133,Alabama,Winston County,23968,35362,44.6,17255,1354,876,7295,90,438,892,584,308,738,603,135,1168,920,248,1173,924,249,12.924,7.238,6.004
01003,Alabama,Baldwin County,203360,52562,42.6,143022,29237,14731,55470,1968,4030,7596,5693,1903,7622,6129,1493,9494,6534,2960,10134,8020,2114,30.742,10.813,7.265
01043,Alabama,Cullman County,81703,40997,40.6,56720,5409,3048,23271,511,1495,3358,2620,738,3357,2541,816,4475,3097,1378,4361,3200,1161,14.91,8.62,6.424
01051,Alabama,Elmore County,80989,54981,38.5,55278,7983,4646,21245,686,1074,3163,2643,520,3478,3087,391,3813,2832,981,4833,4102,731,22.846,8.284,5.055
01069,Alabama,Houston County,104108,42803,39.6,71238,9418,5485,25570,763,1515,4022,3055,967,4286,3368,918,5769,3967,1802,6359,5261,1098,20.92,8.909,5.925
01071,Alabama,Jackson County,52326,39281,43,37016,3192,1764,14992,298,744,2137,1611,526,1888,1603,285,2393,1408,985,2629,1865,764,13.389,6.95,4.963
01121,Alabama,Talladega County,80888,39219,40.6,56103,4620,2986,22859,634,1266,3143,2328,815,3378,2677,701,3971,2982,989,4645,3558,1087,13.557,8.312,5.538
01125,Alabama,Tuscaloosa County,204424,50513,32.3,125145,23230,14595,44920,1547,3046,17041,14296,2745,16018,13560,2458,12685,10189,2496,13228,11783,1445,30.225,10.225,6.781
01129,Alabama,Washington County,16746,42185,43.5,11607,785,453,4946,128,264,684,568,116,570,501,69,772,607,165,795,655,140,10.666,7.926,5.338
01027,Alabama,Clay County,13407,37287,43.8,9455,562,408,4082,85,278,430,357,73,606,498,108,444,326,118,700,432,268,10.259,8.893,6.81
01031,Alabama,Coffee County,51073,49821,39.3,34736,5111,2766,12822,266,489,1982,1276,706,2126,1512,614,2539,1981,558,2634,2103,531,22.677,5.888,3.814
01103,Alabama,Morgan County,119157,47529,40.1,82094,11822,5320,32858,767,1865,4664,3273,1391,4529,3560,969,6475,4674,1801,6529,4823,1706,20.881,8.01,5.676
01109,Alabama,Pike County,33287,35684,31.4,19657,2930,1930,7277,139,341,3692,3118,574,3574,3230,344,1585,1260,325,2026,1810,216,24.724,6.596,4.686
01021,Alabama,Chilton County,43805,43501,38.9,29697,2809,1675,12625,304,818,1801,1197,604,2018,1408,610,2381,1344,1037,2391,1768,623,15.099,8.887,6.479
01033,Alabama,Colbert County,54435,45477,42.5,38423,4403,2804,16009,309,1019,2326,1869,457,2072,1799,273,2598,2005,593,3082,2631,451,18.757,8.295,6.365
01037,Alabama,Coosa County,10955,34792,45.9,8117,611,281,3377,127,276,456,273,183,436,375,61,319,206,113,536,389,147,10.989,11.934,8.173
01045,Alabama,Dale County,49393,44711,37.1,33288,3688,1899,11237,245,585,1547,927,620,1960,1556,404,2545,1773,772,3037,2381,656,16.784,7.386,5.206
01065,Alabama,Hale County,14995,34679,39.8,10161,1008,456,4241,125,305,632,464,168,600,491,109,638,519,119,769,506,263,14.408,10.139,7.192
01055,Alabama,Etowah County,103132,42064,40.9,71745,7435,4684,28096,777,1410,4232,3264,968,4212,3514,698,5340,3724,1616,5560,4284,1276,16.892,7.784,5.019
01049,Alabama,DeKalb County,71194,38842,39,47694,3638,2564,18155,484,591,3004,1972,1032,2947,2111,836,3871,2536,1335,3806,2420,1386,13.004,5.921,3.255
01053,Alabama,Escambia County,37621,35026,39.6,25896,1956,1190,9490,182,380,1528,931,597,1267,955,312,1817,1389,428,1876,1441,435,12.149,5.922,4.004
01075,Alabama,Lamar County,14021,36016,44.5,9938,880,437,4560,70,138,468,316,152,490,335,155,604,572,32,723,524,199,13.252,4.561,3.026
01111,Alabama,Randolph County,22530,39485,42.7,15594,1415,854,6448,74,365,914,676,238,1042,733,309,1004,690,314,906,718,188,14.55,6.808,5.661
01013,Alabama,Butler County,20126,36326,40.7,13958,1342,911,4940,159,352,847,668,179,878,605,273,955,707,248,1109,842,267,16.141,10.344,7.126
01097,Alabama,Mobile County,414328,45802,37.3,275878,42066,21479,102051,3197,7022,18605,13849,4756,20218,15986,4232,22440,16349,6091,26049,20114,5935,23.034,10.014,6.881
01035,Alabama,Conecuh County,12649,30434,44.5,8772,458,310,3658,41,229,558,359,199,453,149,304,622,390,232,399,268,131,8.755,7.381,6.26
01105,Alabama,Perry County,9680,22973,37.6,5858,512,479,2287,38,290,669,376,293,720,517,203,280,175,105,314,175,139,16.917,14.342,12.68
01127,Alabama,Walker County,64927,38872,42.3,45197,3014,1996,19019,400,864,2700,2055,645,2687,2195,492,3333,2288,1045,3316,2547,769,11.085,6.646,4.543
01029,Alabama,Cleburne County,14939,37396,41.7,10387,807,476,4296,164,340,566,443,123,490,365,125,647,475,172,750,548,202,12.352,11.732,7.914
01063,Alabama,Greene County,8533,20954,42,5830,486,177,2058,11,191,469,381,88,317,273,44,404,248,156,420,287,133,11.372,9.815,9.281
01005,Alabama,Barbour County,26201,33368,39.7,18434,1403,815,5745,125,295,924,578,346,985,797,188,1359,951,408,1287,981,306,12.032,7.311,5.135
01007,Alabama,Bibb County,22580,43404,39.8,15859,1289,808,5212,139,169,888,771,117,849,795,54,1377,1187,190,1101,883,218,13.223,5.909,3.243
01011,Alabama,Bullock County,10478,29655,40.8,7377,485,505,2570,43,80,485,316,169,444,271,173,527,286,241,387,282,105,13.42,4.786,3.113
01015,Alabama,Calhoun County,115527,43686,39.1,78975,8092,6021,31295,833,1476,5441,4100,1341,5256,4433,823,6027,4236,1791,6910,5757,1153,17.87,7.378,4.716
01017,Alabama,Chambers County,33895,37342,43,23698,2131,1027,9103,278,637,1617,1102,515,1585,1121,464,1618,1157,461,1664,1289,375,13.326,10.052,6.998
01025,Alabama,Clarke County,24625,33827,42.2,16921,1422,771,6336,88,320,1051,734,317,1068,738,330,1098,898,200,1243,869,374,12.96,6.439,5.051
01057,Alabama,Fayette County,16657,36541,43.6,11715,1178,534,5345,152,197,651,505,146,676,539,137,843,693,150,751,665,86,14.614,6.529,3.686
01101,Alabama,Montgomery County,227120,46545,35.9,149318,28898,19265,53063,2154,3323,11387,8273,3114,12315,9729,2586,13295,9432,3863,14921,11743,3178,32.255,10.322,6.262
01095,Alabama,Marshall County,94738,41104,38.8,63248,7353,3859,24437,617,1621,4329,2677,1652,3979,2980,999,5067,3260,1807,4860,3022,1838,17.727,9.158,6.633
01009,Alabama,Blount County,57667,47412,40.9,39475,3416,1756,16246,401,738,2484,1973,511,2171,1761,410,2874,2137,737,3047,2479,568,13.102,7.011,4.543
01067,Alabama,Henry County,17110,45569,43.5,12123,1087,987,5531,116,348,720,428,292,562,432,130,604,424,180,822,756,66,17.108,8.389,6.292
01089,Alabama,Madison County,353213,61318,38.2,239756,60410,36912,96031,2229,4689,16552,13159,3393,16994,14116,2878,20988,16448,4540,21516,17096,4420,40.592,7.204,4.883
01001,Alabama,Autauga County,55036,55317,37.8,36757,5316,3860,15430,501,870,2413,1879,534,2180,1705,475,2801,2417,384,3122,2579,543,24.964,8.885,5.638
01123,Alabama,Tallapoosa County,40756,42181,43.3,28609,3474,1736,11763,205,795,1888,1421,467,1532,1311,221,1703,1354,349,2080,1512,568,18.211,8.501,6.758
01061,Alabama,Geneva County,26572,39293,42.7,18666,1407,669,7873,230,361,969,579,390,1034,746,288,1194,771,423,1309,942,367,11.122,7.507,4.585
01131,Alabama,Wilcox County,10919,27012,40.5,7242,578,290,2388,55,101,497,255,242,515,296,219,410,240,170,539,400,139,11.986,6.533,4.229
02150,Alaska,Kodiak Island Borough,13773,74167,33.1,8968,1374,785,2679,113,158,581,399,182,505,375,130,1096,650,446,917,671,246,24.074,10.116,5.898
02068,Alaska,Denali Borough,2303,83295,38.4,1590,483,224,533,2,19,173,119,54,180,141,39,120,72,48,158,133,25,44.465,3.94,3.565
02261,Alaska,Valdez-Cordova Census Area,9439,86019,40,6392,1475,612,2092,0,71,615,358,257,243,164,79,375,241,134,597,535,62,32.65,3.394,3.394
02122,Alaska,Kenai Peninsula Borough,57961,65279,40.6,39960,6139,3508,15508,422,1182,2538,1539,999,1941,1414,527,2899,1995,904,3083,2196,887,24.142,10.343,7.622
02016,Alaska,Aleutians West Census Area,5784,85192,37.7,4147,517,154,367,13,12,330,240,90,240,209,31,601,381,220,318,217,101,16.18,6.812,3.27
02060,Alaska,Bristol Bay Borough,917,79500,41.8,650,99,33,205,2,6,34,23,11,17,15,2,39,28,11,44,32,12,20.308,3.902,2.927
02188,Alaska,Northwest Arctic Borough,7715,61533,26.6,4095,292,149,1055,12,26,509,218,291,423,253,170,551,214,337,504,300,204,10.769,3.602,2.464
02050,Alaska,Bethel Census Area,17957,53853,26.9,9578,748,457,2861,18,122,987,514,473,1008,639,369,1133,666,467,1098,855,243,12.581,4.893,4.264
02185,Alaska,North Slope Borough,9757,77266,34.6,6490,707,288,1060,10,34,447,251,196,356,240,116,967,746,221,572,420,152,15.331,4.151,3.208
02220,Alaska,Sitka City and Borough,8810,70765,38.9,6168,1210,820,2008,55,149,282,205,77,336,252,84,538,352,186,580,410,170,32.912,10.159,7.42
02090,Alaska,Fairbanks North Star Borough,100031,76250,31,61853,12885,7586,21466,601,1706,6135,5182,953,5166,4561,605,6798,5252,1546,7168,6556,612,33.096,10.747,7.947
02130,Alaska,Ketchikan Gateway Borough,13745,67321,39.5,9514,1534,761,3261,116,176,556,373,183,483,412,71,810,570,240,803,640,163,24.122,8.954,5.397
02170,Alaska,Matanuska-Susitna Borough,101135,74887,34.9,64554,8812,4454,23409,802,1781,4837,3154,1683,4055,2938,1117,6104,4279,1825,6049,4598,1451,20.55,11.034,7.608
02282,Alaska,Yakutat City and Borough,682,64583,39.4,480,81,13,154,3,8,32,18,14,29,21,8,34,27,7,47,43,4,19.583,7.143,5.195
02180,Alaska,Nome Census Area,9869,53821,27.9,5443,534,226,1755,47,101,516,228,288,483,298,185,684,300,384,615,436,179,13.963,8.433,5.755
02070,Alaska,Dillingham Census Area,4974,58708,30.1,2876,285,214,871,9,23,281,122,159,284,180,104,333,213,120,298,231,67,17.35,3.674,2.641
02100,Alaska,Haines Borough,2537,70640,45,1867,403,245,769,65,13,114,48,66,41,40,1,204,148,56,128,117,11,34.708,10.143,1.691
02110,Alaska,Juneau City and Borough,32434,90749,38,22346,5832,3166,8033,314,326,1412,1173,239,1638,1256,382,1989,1589,400,1931,1643,288,40.267,7.967,4.058
02164,Alaska,Lake and Peninsula Borough,1301,45208,32.3,789,66,60,278,4,6,92,32,60,58,32,26,66,32,34,115,87,28,15.97,3.597,2.158
02240,Alaska,Southeast Fairbanks Census Area,6889,63866,36.6,4473,449,424,1533,12,72,273,146,127,233,192,41,472,290,182,355,265,90,19.517,5.479,4.697
02290,Alaska,Yukon-Koyukuk Census Area,5453,37819,34.7,3450,255,174,1379,13,23,291,108,183,232,116,116,336,136,200,282,166,116,12.435,2.611,1.668
02020,Alaska,Anchorage Municipality,298225,82271,33.1,192310,42216,24273,63722,2520,3846,15014,11554,3460,14891,12044,2847,21100,16625,4475,21305,17189,4116,34.574,9.99,6.036
02013,Alaska,Aleutians East Borough,3338,66607,42.7,2555,196,97,482,2,23,198,97,101,114,54,60,296,89,207,160,57,103,11.468,5.187,4.772
02198,Alaska,Prince of Wales-Hyder Census Area,6473,52114,41,4455,478,270,1690,16,32,262,143,119,192,127,65,372,175,197,350,249,101,16.79,2.84,1.893
02275,Alaska,Wrangell City and Borough,2475,56094,49.1,1857,239,122,722,15,26,82,32,50,57,42,15,109,74,35,123,82,41,19.44,5.679,3.601
02105,Alaska,Hoonah-Angoon Census Area,2146,57900,48.9,1651,248,113,590,16,14,80,36,44,56,32,24,99,45,54,75,46,29,21.866,5.085,2.373
02230,Alaska,Skagway Municipality,1038,70673,42.9,829,203,64,220,14,3,38,24,14,39,21,18,105,70,35,66,58,8,32.207,7.727,1.364
02195,Alaska,Petersburg Borough,3275,63490,41.7,2179,429,148,856,15,27,243,236,7,115,71,44,113,74,39,153,134,19,26.48,4.907,3.154
02158,Alaska,Kusilvak Census Area,8129,36468,24,3923,119,73,1296,9,31,478,261,217,474,308,166,666,335,331,461,346,115,4.894,3.086,2.392
04019,Arizona,Pima County,1007257,48676,38.2,666989,121598,89282,246837,9798,18698,56660,44620,12040,58054,47713,10341,54232,42034,12198,53008,45525,7483,31.617,11.544,7.575
04013,Arizona,Maricopa County,4155501,58580,36,2730613,546841,311931,908516,34851,70058,203701,155569,48132,195770,159506,36264,263576,201695,61881,258880,217986,40894,31.45,11.547,7.711
04007,Arizona,Gila County,53145,41179,49.3,38632,4513,2828,15729,435,1062,1746,1126,620,1779,1399,380,2249,1670,579,2218,1824,394,19.002,9.517,6.752
04009,Arizona,Graham County,37700,48173,33.1,23350,2120,1177,7469,128,303,1614,1307,307,1793,1458,335,1799,1539,260,2015,1754,261,14.12,5.771,4.057
04023,Arizona,Santa Cruz County,46358,39630,36.6,28877,4380,2015,10468,605,1165,1878,1543,335,2294,1902,392,2106,1623,483,2162,1902,260,22.146,16.909,11.129
04003,Arizona,Cochise County,126516,47847,40.5,87509,12916,7760,33878,1101,2193,3538,2650,888,4630,4135,495,4831,4147,684,6258,5602,656,23.627,9.723,6.473
04012,Arizona,La Paz County,20477,36479,56,15536,1145,601,6533,63,310,643,441,202,615,581,34,732,502,230,722,498,224,11.238,5.709,4.745
04015,Arizona,Mohave County,204691,41567,50.4,153930,12194,6782,57336,2259,4397,6796,5081,1715,6219,5281,938,8474,5776,2698,8600,7118,1482,12.328,11.609,7.669
04001,Arizona,Apache County,71602,32360,34.2,43766,3340,1680,15164,150,476,3595,2296,1299,3575,2451,1124,3821,2307,1514,3463,2404,1059,11.47,4.128,3.139
04005,Arizona,Coconino County,138639,53523,30.6,80822,16933,11689,28235,1134,1981,12058,9396,2662,12655,10955,1700,8372,6159,2213,7869,6335,1534,35.414,11.032,7.016
04025,Arizona,Yavapai County,220972,48259,52.2,168134,24698,17370,66683,3052,6604,8012,6499,1513,6247,4981,1266,8887,6715,2172,8951,7259,1692,25.021,14.48,9.904
04027,Arizona,Yuma County,204281,43253,34.1,127583,11782,6513,48381,1941,3306,11142,7701,3441,9649,7588,2061,11497,8569,2928,11113,9147,1966,14.34,10.845,6.833
04011,Arizona,Greenlee County,9368,56298,33.4,5834,560,147,1586,7,32,484,412,72,344,318,26,616,535,81,590,514,76,12.119,2.459,2.018
04017,Arizona,Navajo County,107902,38798,35.9,68236,6428,4121,23595,614,920,4909,2903,2006,4491,3346,1145,4927,3739,1188,5428,4566,862,15.46,6.501,3.899
04021,Arizona,Pinal County,405537,52628,38.5,276364,32987,18326,96928,3755,6861,14675,11587,3088,13071,10698,2373,19744,15649,4095,21370,18458,2912,18.567,10.952,7.078
05145,Arkansas,White County,78706,44074,36.3,50686,6153,4387,19632,421,862,4616,4123,493,4924,4183,741,4299,3094,1205,4528,3965,563,20.795,6.535,4.391
05099,Arkansas,Nevada County,8528,36995,43.8,5855,676,321,2571,64,70,405,279,126,334,285,49,329,240,89,386,285,101,17.028,5.212,2.723
05123,Arkansas,St. Francis County,26688,33102,38.4,18484,998,761,5462,134,293,1170,849,321,996,866,130,1376,749,627,1231,965,266,9.516,7.818,5.364
05119,Arkansas,Pulaski County,392848,48850,36.7,264775,55304,33844,91503,2900,6213,17815,13444,4371,18550,15453,3097,24347,18476,5871,26547,21931,4616,33.669,9.959,6.79
05021,Arkansas,Clay County,15190,32219,43.4,10667,725,412,4515,101,155,583,423,160,595,448,147,681,534,147,687,593,94,10.659,5.67,3.433
05037,Arkansas,Cross County,17164,41081,40.7,11552,905,684,4543,129,199,658,513,145,667,590,77,784,655,129,835,698,137,13.755,7.22,4.38
05039,Arkansas,Dallas County,7585,35794,43.7,5331,569,183,2156,63,95,209,151,58,284,250,34,325,220,105,276,208,68,14.106,7.328,4.406
05043,Arkansas,Drew County,18620,36092,36.5,11647,1399,751,4625,42,192,1440,1301,139,1105,950,155,893,702,191,1057,912,145,18.46,5.059,4.151
05027,Arkansas,Columbia County,23992,37072,36.2,14863,1997,1193,6138,171,438,1740,1328,412,1721,1428,293,1099,1030,69,1261,1049,212,21.463,9.922,7.136
05121,Arkansas,Randolph County,17514,35930,42.2,12164,1182,579,5282,54,297,832,452,380,618,509,109,840,575,265,857,773,84,14.477,6.645,5.623
05125,Arkansas,Saline County,116252,58985,39,80044,13140,7293,33424,684,1273,4358,3170,1188,4229,3766,463,6380,5111,1269,6969,6068,901,25.527,5.855,3.809
05141,Arkansas,Van Buren County,16751,34428,47.6,12321,946,643,5288,195,246,679,525,154,552,354,198,713,394,319,709,508,201,12.897,8.34,4.652
05009,Arkansas,Boone County,37212,40727,42.2,25897,2721,1482,10729,210,477,1428,1041,387,1405,1084,321,1887,1569,318,1754,1585,169,16.23,6.403,4.446
05065,Arkansas,Izard County,13521,39135,48,10150,874,433,4082,139,239,435,332,103,397,339,58,499,399,100,522,458,64,12.877,9.26,5.855
05063,Arkansas,Independence County,37097,39945,39.8,25097,2861,1661,10105,271,550,1577,1240,337,1523,1108,415,2025,1651,374,1943,1614,329,18.018,8.125,5.443
05079,Arkansas,Lincoln County,13885,38873,38.6,10268,576,239,2946,39,89,271,236,35,351,276,75,312,236,76,577,462,115,7.937,4.345,3.021
05083,Arkansas,Logan County,21802,37982,42.2,15234,1324,511,6062,112,291,901,813,88,848,673,175,898,661,237,1063,932,131,12.045,6.648,4.8
05053,Arkansas,Grant County,18076,49968,39.9,12460,1577,790,5469,105,318,709,603,106,676,619,57,911,744,167,974,847,127,18.997,7.735,5.815
05035,Arkansas,Crittenden County,49278,38558,35,31104,3440,1822,10587,303,574,2227,1836,391,2330,1813,517,2471,2003,468,3190,2600,590,16.917,8.284,5.422
05047,Arkansas,Franklin County,17803,39472,41.4,12127,1060,311,5052,83,267,808,559,249,719,539,180,788,694,94,928,740,188,11.305,6.928,5.285
05045,Arkansas,Faulkner County,121282,50316,32.3,73744,13732,8159,27329,717,1544,8714,6757,1957,9630,8101,1529,7505,6220,1285,7544,6345,1199,29.685,8.273,5.65
05109,Arkansas,Pike County,10893,36893,41.8,7609,609,524,3329,94,195,494,317,177,389,315,74,521,424,97,503,360,143,14.89,8.681,5.858
05069,Arkansas,Jefferson County,71373,37630,39,47738,5136,2887,17387,499,1286,3224,2414,810,3542,3021,521,3359,2627,732,3804,3112,692,16.806,10.266,7.396
05089,Arkansas,Marion County,16374,36113,51.8,12502,1270,734,5224,217,259,457,385,72,501,383,118,699,515,184,631,553,78,16.029,9.112,4.958
05097,Arkansas,Montgomery County,9059,35252,50,6762,511,320,3147,98,118,246,138,108,279,205,74,326,226,100,332,231,101,12.289,6.864,3.75
05127,Arkansas,Scott County,10584,37396,41.2,7143,368,361,2930,84,79,405,363,42,430,342,88,490,308,182,498,429,69,10.206,5.563,2.696
05129,Arkansas,Searcy County,7925,36716,47.3,5841,429,336,2649,13,67,232,197,35,229,166,63,352,228,124,410,374,36,13.097,3.02,2.529
05131,Arkansas,Sebastian County,127362,40932,37.3,84291,11009,5038,30067,674,1542,5612,4110,1502,6214,4858,1356,7899,6148,1751,7014,5334,1680,19.038,7.37,5.129
05033,Arkansas,Crawford County,62119,43504,38.7,41681,4184,1864,18066,424,733,2386,1733,653,2307,1841,466,3175,2516,659,3717,2894,823,14.51,6.404,4.057
05007,Arkansas,Benton County,251823,61271,35.2,163405,34624,17108,60275,1957,2710,10525,8507,2018,10603,8759,1844,16487,13080,3407,16586,13603,2983,31.659,7.743,4.496
05017,Arkansas,Chicot County,11008,32412,43.3,7711,727,289,2868,32,163,470,351,119,288,210,78,412,296,116,520,396,124,13.176,6.799,5.683
05059,Arkansas,Hot Spring County,33480,40626,41.7,23757,2077,1205,9197,223,459,1396,1156,240,1123,810,313,1866,1335,531,1783,1404,379,13.815,7.415,4.991
05071,Arkansas,Johnson County,26155,35758,37.8,17133,1714,983,7011,192,360,1215,848,367,1225,881,344,1368,1009,359,1371,1199,172,15.742,7.873,5.135
05077,Arkansas,Lee County,9614,27901,41.9,6893,395,184,1963,54,67,379,240,139,328,252,76,484,279,205,385,306,79,8.4,6.164,3.413
05087,Arkansas,Madison County,15907,42894,42.5,10914,793,468,4735,109,179,572,373,199,531,392,139,810,631,179,816,701,115,11.554,6.082,3.78
05041,Arkansas,Desha County,12094,27036,40.2,7981,722,286,3039,77,106,416,328,88,421,328,93,389,250,139,735,628,107,12.63,6.022,3.488
05049,Arkansas,Fulton County,12092,36051,48.1,8828,687,385,3997,200,280,408,270,138,416,360,56,472,275,197,487,395,92,12.143,12.009,7.005
05061,Arkansas,Howard County,13472,34851,38.5,8938,1023,344,3339,80,124,372,245,127,451,337,114,760,594,166,682,497,185,15.294,6.11,3.714
05051,Arkansas,Garland County,97994,41672,44.7,70624,9096,5129,26839,730,1425,3671,2419,1252,3601,2523,1078,4711,3262,1449,4925,3696,1229,20.142,8.029,5.309
05093,Arkansas,Mississippi County,43534,36417,36.1,27903,2227,1168,9722,244,483,1993,1354,639,2241,1760,481,2336,1880,456,2349,1974,375,12.167,7.478,4.968
05115,Arkansas,Pope County,63372,40668,34.9,39964,5826,3051,15511,373,921,4228,3584,644,4197,3411,786,3638,2834,804,3783,2995,788,22.212,8.342,5.938
05117,Arkansas,Prairie County,8309,41244,45.7,6009,602,229,2776,39,118,270,153,117,279,245,34,387,305,82,396,351,45,13.829,5.656,4.251
05139,Arkansas,Union County,40022,41106,39.7,27264,3928,1558,11892,189,516,1647,1114,533,1613,1177,436,1944,1383,561,2322,1759,563,20.122,5.928,4.339
05147,Arkansas,Woodruff County,6763,30097,45.3,4827,436,114,1892,34,62,242,169,73,240,228,12,278,158,120,282,238,44,11.394,5.074,3.277
05023,Arkansas,Cleburne County,25361,42312,48.9,18802,1800,1182,7988,173,326,903,607,296,780,628,152,1042,686,356,1102,931,171,15.86,6.247,4.081
05025,Arkansas,Cleveland County,8332,44840,42.6,5735,641,334,2436,52,61,334,241,93,307,246,61,338,281,57,367,305,62,17.001,4.639,2.504
05067,Arkansas,Jackson County,17429,32783,40.5,12454,755,395,4362,99,136,581,404,177,485,364,121,842,591,251,488,364,124,9.234,5.387,3.118
05057,Arkansas,Hempstead County,22154,38701,38.9,14441,1228,659,5461,98,269,1000,773,227,1027,891,136,831,573,258,1071,905,166,13.067,6.72,4.926
05135,Arkansas,Sharp County,17041,31792,47.3,12317,762,529,5360,288,272,449,250,199,611,411,200,724,560,164,632,557,75,10.481,10.448,5.075
05137,Arkansas,Stone County,12443,33091,49.5,9127,698,521,3790,237,241,466,321,145,310,226,84,486,431,55,509,383,126,13.356,12.612,6.359
05143,Arkansas,Washington County,223683,47452,31.5,134615,25446,17516,45031,858,1865,16407,13599,2808,15800,13692,2108,15610,11513,4097,14710,11841,2869,31.915,6.047,4.142
05055,Arkansas,Greene County,44197,45566,37.7,29424,3204,1543,11323,154,342,2099,1585,514,1908,1598,310,2544,2039,505,2511,2214,297,16.133,4.38,3.02
05005,Arkansas,Baxter County,41093,40072,51.8,31590,3914,1906,13864,466,780,1285,1082,203,1292,1194,98,1622,1327,295,1733,1461,272,18.424,8.987,5.626
05003,Arkansas,Ashley County,20771,36407,41.8,14166,1333,566,6054,96,246,927,661,266,801,596,205,906,593,313,978,760,218,13.405,5.649,4.063
05031,Arkansas,Craighead County,104246,45672,34,66594,11235,6434,23238,411,778,6278,5216,1062,6082,5333,749,6382,4751,1631,6978,5708,1270,26.532,5.117,3.348
05073,Arkansas,Lafayette County,7051,32500,45.8,5088,612,150,2076,62,161,281,140,141,219,187,32,342,219,123,352,249,103,14.976,10.742,7.755
05105,Arkansas,Perry County,10320,46168,43.7,7202,692,240,3006,52,44,436,366,70,328,270,58,513,427,86,454,368,86,12.941,3.194,1.464
05149,Arkansas,Yell County,21601,39696,39.7,14546,1415,572,5355,241,198,839,684,155,920,789,131,1111,894,217,880,667,213,13.66,8.198,3.697
05107,Arkansas,Phillips County,19518,26652,38.2,12482,863,550,3725,38,291,796,477,319,1076,854,222,818,632,186,959,696,263,11.32,8.832,7.812
05111,Arkansas,Poinsett County,24098,37487,39.7,16332,1160,437,6138,148,218,1000,623,377,1218,844,374,1228,904,324,1176,932,244,9.778,5.963,3.552
05133,Arkansas,Sevier County,17206,43675,35,10640,699,434,4504,115,239,830,600,230,835,559,276,907,637,270,788,596,192,10.648,7.86,5.306
05013,Arkansas,Calhoun County,5194,37225,45.2,3719,302,155,1714,39,47,264,213,51,194,161,33,261,188,73,182,133,49,12.288,5.018,2.742
05019,Arkansas,Clark County,22495,37144,33.8,13186,2165,1313,5470,147,170,2205,1863,342,2190,1929,261,860,628,232,940,774,166,26.376,5.795,3.108
05011,Arkansas,Bradley County,10994,36310,40.6,7530,736,351,2828,13,161,320,216,104,419,199,220,643,450,193,523,371,152,14.436,6.153,5.693
05075,Arkansas,Lawrence County,16777,37603,42,11386,1198,563,4422,88,141,783,651,132,809,643,166,792,658,134,771,689,82,15.466,5.179,3.189
05095,Arkansas,Monroe County,7420,31584,46.1,5193,379,105,2054,20,90,307,209,98,344,227,117,229,140,89,254,175,79,9.32,5.355,4.382
05113,Arkansas,Polk County,20212,33870,43.8,14096,1110,658,6150,397,462,689,442,247,614,331,283,961,658,303,1062,793,269,12.543,13.967,7.512
05029,Arkansas,Conway County,20954,39638,41.2,14496,1500,797,5803,260,273,761,618,143,740,607,133,1201,1011,190,1119,875,244,15.846,9.185,4.704
05103,Arkansas,Ouachita County,24378,32136,42.8,16834,1549,1027,6734,77,298,926,758,168,855,678,177,924,745,179,1365,1156,209,15.302,5.569,4.425
05101,Arkansas,Newton County,7898,38134,48.8,5795,582,327,2683,107,124,264,211,53,197,183,14,360,302,58,329,214,115,15.686,8.61,4.622
05001,Arkansas,Arkansas County,18352,38532,40.9,12722,1241,552,4822,115,198,717,471,246,804,713,91,933,675,258,989,864,125,14.094,6.491,4.106
05081,Arkansas,Little River County,12494,36963,42.5,8956,661,260,3691,6,106,404,174,230,372,310,62,647,394,253,678,515,163,10.284,3.034,2.872
05085,Arkansas,Lonoke County,71568,57290,35.8,46871,6732,2701,17996,462,807,2936,2341,595,2952,2320,632,4108,3525,583,4435,3715,720,20.125,7.052,4.484
05015,Arkansas,Carroll County,27782,39686,44.6,19549,2302,1480,8398,312,534,965,719,246,901,648,253,1236,763,473,1346,928,418,19.346,10.074,6.359
05091,Arkansas,Miller County,43760,41862,38.5,29694,3211,1470,10802,327,330,1805,1203,602,1595,1083,512,2366,1896,470,2738,2082,656,15.764,6.082,3.055
06049,California,Modoc County,9017,39296,47.8,6852,859,277,2655,210,239,238,160,78,161,61,100,364,303,61,585,431,154,16.579,16.911,9.002
06047,California,Merced County,267390,46338,30.8,156562,14006,7535,41206,2166,3891,15582,12577,3005,14327,12621,1706,17022,12414,4608,15980,13930,2050,13.759,14.699,9.443
06033,California,Lake County,64095,40446,45.8,46386,4588,2528,17362,848,1976,2441,1842,599,2187,1844,343,3267,2200,1067,2942,2284,658,15.341,16.265,11.381
06043,California,Mariposa County,17658,51385,51.1,13656,2017,1318,5259,110,568,510,463,47,518,491,27,829,709,120,863,804,59,24.421,12.892,10.801
06115,California,Yuba County,74644,51776,32.4,46582,5573,2055,15063,920,1216,3358,2625,733,3230,2739,491,4821,3526,1295,5035,4421,614,16.375,14.18,8.073
06013,California,Contra Costa County,1123678,88456,39.2,767132,198521,113984,255201,13728,26846,48852,42376,6476,46268,40378,5890,62903,51038,11865,63907,56200,7707,40.737,15.899,10.52
06027,California,Inyo County,18195,51500,45.6,13230,2103,1241,5109,168,381,637,513,124,520,459,61,863,657,206,925,745,180,25.276,10.746,7.457
06035,California,Lassen County,31470,54083,36.2,22422,1761,1020,6230,124,451,943,813,130,767,672,95,1090,915,175,1117,1006,111,12.403,9.23,7.239
06099,California,Stanislaus County,535684,54260,33.9,336086,38138,18064,97790,4981,9183,27201,21995,5206,26401,22715,3686,33901,27955,5946,33679,30200,3479,16.723,14.484,9.391
06083,California,Santa Barbara County,442996,68023,33.7,272818,54031,36733,75308,3881,7976,34022,27433,6589,32104,27554,4550,26014,18796,7218,24329,19461,4868,33.269,15.745,10.591
06097,California,Sonoma County,500943,71769,41.4,355303,77016,43246,114608,6424,12163,21896,18208,3688,21329,18604,2725,29292,23727,5565,28473,24318,4155,33.848,16.218,10.613
06103,California,Tehama County,63247,42512,41.1,43113,4202,1993,15934,921,1666,2552,2024,528,2252,1862,390,3217,2619,598,3201,2772,429,14.369,16.236,10.456
06025,California,Imperial County,179957,44779,32.2,108522,10692,4806,25507,1216,2464,8846,7085,1761,8915,7354,1561,9641,7494,2147,10049,8368,1681,14.281,14.427,9.66
06051,California,Mono County,14058,60595,38.3,9692,2250,807,2750,199,277,946,780,166,536,304,232,987,514,473,1092,614,478,31.541,17.309,10.073
06069,California,San Benito County,58671,80760,35.4,37357,4980,2190,11103,711,1257,2910,2452,458,2714,2451,263,3503,2483,1020,3394,2728,666,19.193,17.725,11.321
06001,California,Alameda County,1629615,85743,37.3,1139149,293137,216157,301667,13843,30155,75918,65990,9928,75714,67864,7850,117513,99784,17729,118924,107981,10943,44.708,14.585,9.996
06067,California,Sacramento County,1495400,60239,35.9,996195,196514,101072,295276,14630,29142,71540,60065,11475,70330,61614,8716,100028,81733,18295,102847,90644,12203,29.872,14.824,9.869
06017,California,El Dorado County,185015,74885,45.5,132744,28348,15900,51948,2566,6194,7562,6538,1024,6310,5648,662,7841,6333,1508,7986,6866,1120,33.333,16.863,11.923
06055,California,Napa County,141005,79637,40.8,97924,22344,11511,30954,1647,3311,6404,5500,904,5924,5353,571,8009,6735,1274,7543,6550,993,34.573,16.017,10.697
06073,California,San Diego County,3283665,70588,35.4,2197045,505483,315431,589144,33826,70094,169901,137638,32263,162530,137424,25106,225562,179240,46322,224117,193529,30588,37.364,17.639,11.898
06053,California,Monterey County,433168,63249,33.9,273560,39587,25854,63873,3679,7418,21278,15691,5587,21075,16985,4090,27125,19091,8034,25776,19722,6054,23.922,17.374,11.614
06075,California,San Francisco County,864263,96265,38.3,683074,228294,152772,133812,6951,15696,38050,33562,4488,38790,35209,3581,92827,84178,8649,86470,80539,5931,55.787,16.924,11.73
06091,California,Sierra County,2885,44190,55,2313,344,151,963,32,65,43,11,32,66,64,2,86,55,31,62,42,20,21.401,10.073,6.75
06107,California,Tulare County,458809,44871,30.6,266582,24752,12139,75975,4564,9176,24084,17836,6248,22652,18834,3818,28928,20492,8436,28706,24001,4705,13.839,18.085,12.078
06113,California,Yolo County,212605,61621,30.9,124232,25761,24644,37809,1510,3082,19058,16652,2406,20896,19599,1297,12448,10028,2420,12459,10971,1488,40.573,12.145,8.151
06023,California,Humboldt County,135490,43718,37.7,91359,17668,9216,30500,1640,3522,8130,6540,1590,8419,6834,1585,8396,6149,2247,7839,6448,1391,29.427,16.925,11.548
06057,California,Nevada County,98838,60610,49.8,75012,17134,9740,29975,1883,3934,3294,2607,687,2848,2326,522,4444,3511,933,4267,3433,834,35.826,19.406,13.124
06003,California,Alpine County,1203,63438,44.9,811,121,87,253,2,59,80,62,18,30,27,3,45,25,20,40,37,3,25.647,24.111,23.32
06039,California,Madera County,154440,48210,33.7,96096,8945,4351,27701,1483,2879,7428,5386,2042,7105,5887,1218,8230,5675,2555,8729,7572,1157,13.836,15.747,10.393
06045,California,Mendocino County,87497,46528,42.4,61673,10117,5168,20230,954,2630,3378,2582,796,3026,2605,421,4695,3293,1402,4501,3859,642,24.784,17.716,13
06087,California,Santa Cruz County,273263,73663,37.3,177627,41971,28636,56992,3279,6755,18937,17190,1747,19080,17105,1975,15514,12346,3168,14149,12133,2016,39.75,17.606,11.853
06105,California,Trinity County,13037,36563,51.4,10098,1556,410,3758,172,421,362,304,58,238,194,44,434,244,190,455,401,54,19.469,15.78,11.203
06037,California,Los Angeles County,10105722,61015,36,6801851,1384333,739973,1512364,94534,222542,537500,414413,123087,527403,434586,92817,712128,528485,183643,691435,566712,124723,31.231,20.966,14.715
06065,California,Riverside County,2355002,60807,35,1500538,205329,117606,462788,27172,57041,120959,93504,27455,117692,97584,20108,140934,105031,35903,139672,114952,24720,21.521,18.197,12.326
06071,California,San Bernardino County,2121220,57156,32.9,1313298,168511,91159,369329,21299,43017,113126,90745,22381,113148,96785,16363,132200,103157,29043,135258,113458,21800,19.772,17.414,11.647
06085,California,Santa Clara County,1911226,106761,37,1310623,351778,303823,358864,17644,35957,91613,80092,11521,80879,72138,8741,140077,123460,16617,127276,116695,10581,50.022,14.936,10.02
06041,California,Marin County,260814,104703,46.1,191055,62021,47855,67296,3744,8539,7495,6788,707,7135,6380,755,10255,8354,1901,9959,8849,1110,57.51,18.252,12.689
06061,California,Placer County,374985,80488,41.6,260802,65212,32559,98153,4698,10165,14152,11892,2260,13922,12453,1469,18281,14998,3283,18357,16284,2073,37.489,15.143,10.356
06093,California,Siskiyou County,43530,40884,47.9,31749,4777,2427,12457,686,979,1419,1195,224,1299,1086,213,2098,1695,403,1946,1670,276,22.69,13.366,7.859
06089,California,Shasta County,178919,47258,41.8,125093,17495,9220,44095,2099,4571,7572,6056,1516,7344,6237,1107,10039,7872,2167,9679,8243,1436,21.356,15.126,10.366
06095,California,Solano County,434981,72950,37.7,295232,52721,22756,88381,4841,8360,21209,17783,3426,19466,17172,2294,25191,20745,4446,26719,23854,2865,25.565,14.936,9.459
06015,California,Del Norte County,27442,41287,38.7,19424,1695,1109,5996,295,440,947,771,176,918,824,94,1193,959,234,1297,1200,97,14.436,12.258,7.338
06011,California,Colusa County,21479,56481,34.7,13509,1524,600,4521,278,319,1098,720,378,971,779,192,1299,923,376,1173,853,320,15.723,13.205,7.056
06021,California,Glenn County,27935,46260,36.8,17927,1819,509,5724,311,483,1323,1013,310,1022,754,268,1405,1045,360,1538,1286,252,12.986,13.871,8.438
06007,California,Butte County,225207,46516,36.9,145918,25811,13036,50844,2082,4123,16491,14043,2448,16166,14358,1808,12626,10042,2584,11721,10473,1248,26.622,12.204,8.109
06031,California,Kings County,150183,49742,31.5,91889,8518,3473,21925,830,1944,7375,5584,1791,6496,5297,1199,8709,6739,1970,8713,7614,1099,13.049,12.652,8.867
06063,California,Plumas County,18724,50266,52.1,14480,1806,1465,6016,250,640,493,403,90,686,582,104,716,701,15,716,643,73,22.59,14.794,10.638
06079,California,San Luis Obispo County,280119,67175,39,185803,39299,23878,63052,2999,7179,21119,18543,2576,17731,15600,2131,14665,11672,2993,13550,11648,1902,34.002,16.142,11.386
06019,California,Fresno County,971616,48730,31.8,588491,78378,40011,160001,7636,15464,53941,40813,13128,52511,43529,8982,62916,46556,16360,62614,53087,9527,20.117,14.437,9.665
06029,California,Kern County,878744,50826,31.3,526286,55523,27558,151564,7832,13167,47457,35878,11579,44686,38012,6674,55511,43267,12244,54225,46506,7719,15.786,13.855,8.687
06059,California,Orange County,3155816,81851,37.5,2132158,537600,295516,588551,32398,69786,157970,129285,28685,153496,130978,22518,201432,158482,42950,193909,164574,29335,39.074,17.362,11.857
06111,California,Ventura County,847834,81972,37.5,562386,114671,68588,170678,9760,19602,41653,32787,8866,40169,34277,5892,49493,35722,13771,47408,38809,8599,32.586,17.203,11.485
06009,California,Calaveras County,45057,54800,51.6,34250,4306,2298,13931,620,2002,1479,1240,239,1384,1094,290,1642,1236,406,1734,1453,281,19.282,18.821,14.371
06101,California,Sutter County,95583,54347,35.7,61768,7398,3419,18357,666,1673,4543,3294,1249,4183,3634,549,5457,4489,968,5698,4473,1225,17.512,12.742,9.114
06081,California,San Mateo County,763450,105667,39.6,544336,153522,110676,156400,8209,17169,30815,26585,4230,29266,26231,3035,50898,44493,6405,47973,43760,4213,48.536,16.226,10.978
06109,California,Tuolumne County,53899,54325,48.6,40935,5362,3058,15458,625,1473,1883,1616,267,1573,1405,168,2343,1928,415,2377,2148,229,20.569,13.572,9.529
06077,California,San Joaquin County,724153,57813,33.9,450857,55477,26026,124734,6498,12220,36414,28854,7560,34798,30401,4397,43464,34199,9265,44031,38244,5787,18.077,15.006,9.797
06005,California,Amador County,37306,60636,50.6,28953,4285,2113,10921,277,1111,999,850,149,972,882,90,1192,1055,137,1363,1279,84,22.098,12.709,10.173
08023,Colorado,Costilla County,3628,29000,51,2650,266,287,1119,33,101,172,128,44,127,112,15,148,95,53,165,129,36,20.868,11.975,9.026
08001,Colorado,Adams County,487850,64087,33.4,310590,48993,22620,105226,5058,8567,22654,16949,5705,21049,16900,4149,35791,26979,8812,35305,29046,6259,23.057,12.948,8.142
08021,Colorado,Conejos County,8147,35657,38.2,5278,741,272,2336,70,195,333,240,93,258,228,30,395,296,99,371,302,69,19.193,11.344,8.348
08027,Colorado,Custer County,4505,41330,58.2,3546,831,349,1714,73,200,135,79,56,67,51,16,167,112,55,122,101,21,33.277,15.928,11.669
08035,Colorado,Douglas County,320940,111154,38.1,209032,78801,42375,90431,2787,6042,10386,9488,898,10260,9708,552,15258,14131,1127,15977,15139,838,57.97,9.763,6.681
08037,Colorado,Eagle County,53726,83803,36.5,37519,12498,4439,12509,487,1419,2619,1975,644,2091,1609,482,4249,2867,1382,3475,2515,960,45.142,15.237,11.344
08065,Colorado,Lake County,7481,46176,39.3,5420,1298,391,1914,66,48,356,321,35,369,336,33,508,340,168,584,399,185,31.162,5.956,2.508
08067,Colorado,La Plata County,54469,62533,39.7,38496,10263,6341,14880,728,1012,2345,2007,338,2509,2088,421,3538,2708,830,3259,2874,385,43.132,11.694,6.801
08081,Colorado,Moffat County,13056,53010,37.7,8853,1055,464,3563,43,198,419,407,12,489,407,82,816,588,228,713,560,153,17.158,6.764,5.557
08097,Colorado,Pitkin County,17747,67755,43.3,13579,5933,2382,4757,157,534,549,407,142,573,272,301,1432,879,553,1206,1076,130,61.234,14.526,11.226
08105,Colorado,Rio Grande County,11430,38534,40.7,7804,1175,671,3143,108,203,407,293,114,361,252,109,582,447,135,659,441,218,23.655,9.895,6.459
08017,Colorado,Cheyenne County,2127,54907,35.8,1325,247,43,570,7,19,67,38,29,57,20,37,112,88,24,95,80,15,21.887,4.561,3.333
08011,Colorado,Bent County,5806,32500,40.4,4572,319,150,1101,13,72,146,115,31,91,69,22,278,131,147,212,184,28,10.258,7.72,6.54
08025,Colorado,Crowley County,5514,35292,38.2,3926,202,117,898,24,123,413,384,29,251,236,15,310,301,9,191,177,14,8.125,16.37,13.697
08033,Colorado,Dolores County,1736,40352,49.4,1312,179,81,564,15,15,26,21,5,52,47,5,142,129,13,46,41,5,19.817,5.319,2.66
08111,Colorado,San Juan County,569,46397,46.9,433,109,20,171,2,30,35,35,0,5,5,0,62,48,14,11,11,0,29.792,18.713,17.544
08057,Colorado,Jackson County,1372,45994,49.2,993,138,26,420,26,18,14,8,6,58,43,15,64,43,21,47,38,9,16.516,10.476,4.286
08069,Colorado,Larimer County,330976,64980,35.7,215266,59389,39410,84626,2690,6146,23888,21318,2570,23143,21629,1514,21558,17568,3990,19835,17984,1851,45.896,10.441,7.263
08075,Colorado,Logan County,21885,44876,37.5,14592,1927,849,5052,161,237,1430,1310,120,1162,1007,155,1396,1113,283,947,925,22,19.024,7.878,4.691
08083,Colorado,Montezuma County,25770,45645,44.1,18102,3149,1923,7385,210,621,1027,581,446,956,820,136,1102,836,266,1194,936,258,28.019,11.253,8.409
08113,Colorado,San Miguel County,7804,62243,42,5843,2278,883,1974,107,337,358,257,101,301,261,40,578,450,128,523,458,65,54.099,22.492,17.072
08119,Colorado,Teller County,23769,66809,49.8,17929,3780,2342,8134,427,550,670,599,71,619,538,81,874,584,290,948,832,116,34.146,12.011,6.762
08125,Colorado,Yuma County,10109,44668,35.8,6649,924,473,2514,157,93,430,327,103,311,253,58,624,483,141,651,462,189,21.011,9.944,3.699
08013,Colorado,Boulder County,316782,75669,36.2,205757,67026,57193,77815,2841,5482,24896,22550,2346,22236,20381,1855,19371,16802,2569,17189,15287,1902,60.372,10.696,7.045
08039,Colorado,Elbert County,24553,92849,45.6,17308,4205,1852,7965,425,771,793,695,98,711,533,178,881,762,119,930,817,113,34.995,15.016,9.68
08071,Colorado,Las Animas County,14151,40586,46,10322,1319,764,4169,152,399,663,600,63,577,502,75,683,608,75,604,567,37,20.18,13.217,9.571
08073,Colorado,Lincoln County,5520,44725,38.5,4057,386,151,1021,11,34,27,17,10,43,38,5,97,87,10,85,79,6,13.236,4.407,3.33
08019,Colorado,Clear Creek County,9257,68534,47.2,7106,2134,1166,3377,236,106,293,250,43,207,197,10,405,284,121,410,370,40,46.44,10.127,3.139
08107,Colorado,Routt County,24359,67472,39.9,17841,6090,3119,6471,303,846,1130,956,174,876,695,181,1795,1318,477,1607,1398,209,51.617,17.756,13.074
08117,Colorado,Summit County,29722,73538,39.2,22379,7963,2731,6287,278,1062,1714,1241,473,1546,1069,477,2560,1470,1090,2038,1468,570,47.786,21.314,16.892
08003,Colorado,Alamosa County,16345,36315,30.3,9411,1542,927,3443,219,261,1215,870,345,1382,1230,152,961,602,359,925,711,214,26.235,13.941,7.581
08029,Colorado,Delta County,30217,42487,47.8,21983,2782,1482,8608,370,940,870,560,310,866,753,113,1160,856,304,1093,944,149,19.397,15.218,10.92
08043,Colorado,Fremont County,46601,44712,44.8,36356,3885,2316,12556,521,814,1309,1011,298,1105,893,212,1381,1080,301,1650,1472,178,17.056,10.632,6.483
08101,Colorado,Pueblo County,163368,42386,38.8,110442,15277,8731,40106,1734,2890,7172,6022,1150,7268,6309,959,8866,6527,2339,9083,8029,1054,21.738,11.529,7.206
08085,Colorado,Montrose County,40908,44865,44.7,28958,4533,2257,11728,467,1189,1284,959,325,1445,1044,401,1901,1347,554,1791,1418,373,23.448,14.12,10.138
08087,Colorado,Morgan County,28123,51456,36.6,18183,1967,1153,6809,230,428,1246,1061,185,1136,980,156,1566,1356,210,1634,1472,162,17.159,9.664,6.286
08093,Colorado,Park County,16900,61644,50.6,13259,2682,1100,6006,426,557,357,334,23,368,331,37,658,527,131,648,533,115,28.524,16.367,9.274
08109,Colorado,Saguache County,6338,34765,48.8,4551,774,410,1855,69,128,176,141,35,204,155,49,228,160,68,237,150,87,26.016,10.62,6.9
08077,Colorado,Mesa County,148798,51971,38.9,101365,18357,9169,40554,1592,3212,7148,6180,968,7189,5962,1227,9021,6474,2547,8284,6823,1461,27.155,11.846,7.92
08099,Colorado,Prowers County,12084,41740,37.4,7831,870,385,3200,128,143,681,476,205,474,431,43,566,390,176,634,567,67,16.026,8.469,4.469
08053,Colorado,Hinsdale County,820,53056,57.2,664,211,60,257,14,20,5,3,2,3,3,0,21,13,8,32,24,8,40.813,13.23,7.782
08041,Colorado,El Paso County,674826,62535,34,432176,97863,63240,157971,6315,12011,31897,26268,5629,31514,27778,3736,40318,32717,7601,43522,38505,5017,37.277,11.601,7.603
08121,Colorado,Washington County,4809,51458,42.2,3377,428,131,1433,30,53,139,135,4,169,165,4,268,219,49,212,196,16,16.553,5.792,3.699
08049,Colorado,Grand County,14793,66489,44.1,11139,3212,1061,3947,147,364,611,388,223,536,298,238,1038,656,382,809,535,274,38.361,12.947,9.222
08005,Colorado,Arapahoe County,626612,69553,36.4,421551,112863,62403,147380,5748,11068,26996,22583,4413,26580,22585,3995,42388,33759,8629,42397,36877,5520,41.576,11.41,7.51
08089,Colorado,Otero County,18325,35051,40.2,12283,1412,767,4813,138,399,923,756,167,923,751,172,785,569,216,818,719,99,17.74,11.157,8.29
08095,Colorado,Phillips County,4327,50076,38.5,2910,439,191,1152,24,48,179,126,53,136,121,15,360,268,92,180,127,53,21.649,6.25,4.167
08007,Colorado,Archuleta County,12592,48016,49.8,9489,2312,1196,4076,175,419,459,245,214,395,300,95,604,334,270,548,344,204,36.969,14.573,10.28
08031,Colorado,Denver County,678467,60098,34.4,483128,137052,87574,143874,5761,11513,31028,24787,6241,33163,29576,3587,69595,55268,14327,66218,57596,8622,46.494,12.006,8.002
08061,Colorado,Kiowa County,1368,39250,41.1,911,134,57,438,0,17,38,34,4,51,37,14,92,78,14,36,36,0,20.966,3.881,3.881
08055,Colorado,Huerfano County,6498,35801,54.9,5142,777,438,2282,184,197,172,86,86,146,122,24,253,202,51,286,246,40,23.629,16.696,8.633
08009,Colorado,Baca County,3581,35898,47.6,2608,416,142,1148,28,88,91,50,41,118,91,27,157,131,26,159,134,25,21.396,10.105,7.666
08015,Colorado,Chaffee County,18818,53762,49.9,14907,2983,1840,6091,244,428,472,414,58,347,309,38,948,538,410,837,604,233,32.354,11.033,7.027
08047,Colorado,Gilpin County,5793,72544,45.2,4492,1089,554,2073,35,303,103,78,25,135,120,15,319,204,115,282,204,78,36.576,16.305,14.616
08063,Colorado,Kit Carson County,7846,45881,38.4,5572,595,287,2093,77,116,232,178,54,161,149,12,549,398,151,410,351,59,15.829,9.221,5.542
08045,Colorado,Garfield County,57945,66503,36.2,38287,7509,4062,13909,690,1600,2361,1570,791,2059,1214,845,3635,2393,1242,3572,2461,1111,30.222,16.464,11.503
08051,Colorado,Gunnison County,16215,52651,34.5,10354,4036,1527,3812,117,361,1592,1398,194,1325,1203,122,1171,734,437,889,555,334,53.728,12.539,9.47
08059,Colorado,Jefferson County,564029,75170,40.4,402392,109340,64210,161274,6075,10980,23457,20522,2935,21359,18902,2457,36499,30401,6098,34384,30384,4000,43.13,10.575,6.808
08079,Colorado,Mineral County,834,50385,58.5,726,177,108,345,13,32,9,6,3,36,36,0,37,25,12,17,13,4,39.256,13.043,9.275
08091,Colorado,Ouray County,4653,61333,53.7,3748,1092,760,1530,57,227,127,104,23,105,87,18,100,84,16,184,163,21,49.413,18.562,14.837
08103,Colorado,Rio Blanco County,6557,57991,35.9,4260,576,316,1667,34,46,347,220,127,291,278,13,360,293,67,405,392,13,20.939,4.799,2.759
08115,Colorado,Sedgwick County,2357,49583,48.4,1656,223,121,710,9,36,92,80,12,55,53,2,66,46,20,70,70,0,20.773,6.338,5.07
08123,Colorado,Weld County,285729,66489,34.2,181832,33853,15194,71451,2586,5260,13427,11380,2047,13076,11569,1507,19049,16013,3036,18677,16106,2571,26.974,10.981,7.362
08014,Colorado,Broomfield County,64283,85639,37.8,44055,14915,8626,17307,697,1013,2538,2230,308,2739,2512,227,4477,3990,487,3746,3379,367,53.435,9.88,5.853
09009,Connecticut,New Haven County,862127,64872,40.1,595779,111795,94583,204037,9244,18594,42094,37171,4923,43056,39555,3501,48739,41703,7036,51211,46412,4799,34.64,13.644,9.113
09005,Connecticut,Litchfield County,184454,76438,46.9,135410,27496,19868,57330,2555,4936,7198,6396,802,6470,6178,292,8192,7023,1169,8016,7421,595,34.978,13.066,8.61
09003,Connecticut,Hartford County,897417,69936,40.4,622863,132166,100525,225378,9075,17375,40468,36216,4252,39236,36593,2643,50662,44057,6605,51778,47907,3871,37.358,11.736,7.709
09015,Connecticut,Windham County,116674,62553,41,80756,11950,7762,31142,1529,2315,6037,5600,437,5806,5550,256,6413,5443,970,6266,5691,575,24.409,12.343,7.434
09011,Connecticut,New London County,270772,69411,41,188628,34115,28033,71447,3122,5534,12347,11171,1176,11981,11346,635,14154,12095,2059,13686,12830,856,32.947,12.115,7.746
09007,Connecticut,Middlesex County,164110,81673,45.1,118781,27082,21324,49088,1869,3570,7203,6783,420,6773,6289,484,7815,7067,748,8004,7212,792,40.752,11.08,7.273
09013,Connecticut,Tolland County,151596,81312,37.9,95679,21525,16479,39710,1585,2357,12770,12185,585,12458,11861,597,6756,6164,592,6638,6267,371,39.72,9.927,5.936
09001,Connecticut,Fairfield County,947328,89773,40.2,642401,165926,132570,228666,11612,25379,41638,33607,8031,40055,34504,5551,48042,36273,11769,48362,40719,7643,46.466,16.177,11.099
10003,Delaware,New Castle County,555036,68336,37.8,377959,77875,57022,138618,4884,10057,27295,24684,2611,27719,25637,2082,33136,28236,4900,34933,31648,3285,35.691,10.779,7.255
10005,Delaware,Sussex County,215551,57901,48.3,159421,23094,16941,68348,2633,5382,7219,5668,1551,6819,5961,858,9753,7735,2018,10355,8615,1740,25.113,11.727,7.874
10001,Delaware,Kent County,173145,57647,37.3,114160,16509,10328,44132,2014,3685,8589,7388,1201,8587,7704,883,9006,7378,1628,10323,9440,883,23.508,12.914,8.35
11001,District of Columbia,District of Columbia,672391,77649,33.9,477843,113830,156593,115795,3913,10223,36302,32967,3335,45066,43194,1872,64007,58607,5400,73343,70459,2884,56.592,12.208,8.829
12113,Florida,Santa Rosa County,166778,62731,39.5,115208,20652,10595,45036,1700,2766,7223,4737,2486,5995,4582,1413,8212,6108,2104,9105,7594,1511,27.122,9.917,6.142
12081,Florida,Manatee County,363542,53408,47.6,268791,47990,30186,100100,2803,6993,12969,9227,3742,12294,9015,3279,15913,10029,5884,17144,12281,4863,29.084,9.786,6.986
12017,Florida,Citrus County,141373,40574,55.9,112033,12905,7089,50556,1476,3139,4101,2904,1197,3644,2656,988,4624,2669,1955,5018,3696,1322,17.847,9.128,6.209
12075,Florida,Levy County,39713,36554,46.4,28851,2183,1262,11848,381,794,1444,979,465,1442,1129,313,1744,1179,565,1918,1316,602,11.941,9.917,6.702
12003,Florida,Baker County,27537,59506,37.1,18290,1689,706,6439,138,491,1428,988,440,1051,846,205,1160,1000,160,1476,1323,153,13.095,9.769,7.625
12127,Florida,Volusia County,518660,43838,46.4,381262,56598,29918,145699,6217,12209,23044,16396,6648,21394,15975,5419,24746,16585,8161,25109,19183,5926,22.692,12.647,8.38
12073,Florida,Leon County,285890,49941,30.5,167484,42853,33380,59141,1838,3814,29294,25172,4122,32912,29665,3247,17480,14560,2920,17806,15615,2191,45.517,9.557,6.449
12011,Florida,Broward County,1890416,54895,40.1,1327173,266661,151191,420780,22189,50831,81122,56657,24465,78441,59232,19209,109670,74609,35061,115224,89181,26043,31.484,17.353,12.08
12079,Florida,Madison County,18518,31816,42.4,13354,993,678,5106,146,402,737,455,282,490,390,100,836,622,214,976,734,242,12.513,10.732,7.873
12087,Florida,Monroe County,76745,63030,46.7,59730,11850,7142,17724,955,2196,2342,1693,649,2267,1543,724,4110,2406,1704,3945,2591,1354,31.796,17.778,12.39
12033,Florida,Escambia County,309924,47361,37,206004,35438,18027,71791,2515,4146,15817,11694,4123,16091,13205,2886,16771,12627,4144,18436,15973,2463,25.953,9.278,5.775
12053,Florida,Hernando County,179144,44324,48.9,133405,15106,7674,56187,1918,3777,6101,4200,1901,5977,4617,1360,7421,4869,2552,7782,6037,1745,17.076,10.136,6.722
12057,Florida,Hillsborough County,1351087,53742,36.8,912588,186135,105477,293143,11601,23284,64772,46521,18251,65482,50603,14879,86138,61741,24397,91079,73036,18043,31.954,11.9,7.943
12091,Florida,Okaloosa County,197591,59955,36.7,134736,25077,15035,48462,1709,3219,7779,5610,2169,8355,6465,1890,11512,8163,3349,12446,9922,2524,29.771,10.169,6.642
12123,Florida,Taylor County,22350,37188,41.4,16155,953,437,5869,136,354,785,429,356,741,606,135,783,618,165,934,797,137,8.604,8.349,6.032
12129,Florida,Wakulla County,31586,57866,40.7,22804,2733,1315,8903,368,374,1040,746,294,1039,745,294,1459,985,474,1471,1342,129,17.751,8.334,4.201
12133,Florida,Washington County,24472,36989,41.9,17464,1251,722,6749,248,411,966,640,326,809,599,210,1269,1082,187,976,784,192,11.298,9.764,6.09
12031,Florida,Duval County,912043,51296,36,617788,120073,57048,200667,7987,16890,40788,30623,10165,43756,36316,7440,61048,44804,16244,66071,54718,11353,28.67,12.397,8.417
12007,Florida,Bradford County,26775,46106,40.9,19351,1480,536,6381,81,390,959,549,410,688,592,96,1255,895,360,1366,1134,232,10.418,7.381,6.112
12009,Florida,Brevard County,568183,51536,47.1,418908,73154,45707,163565,5418,12591,22394,16710,5684,20665,15928,4737,27258,18936,8322,27114,21899,5215,28.374,11.01,7.698
12019,Florida,Clay County,203291,61971,39.4,137354,22532,10024,53528,1866,4027,8530,7022,1508,8004,6682,1322,10370,7439,2931,10634,8785,1849,23.702,11.009,7.523
12067,Florida,Lafayette County,8684,41512,39.2,6159,420,440,1781,38,46,313,43,270,266,90,176,458,240,218,121,121,0,13.963,4.716,2.583
12069,Florida,Lake County,326215,49734,46.6,239378,34652,18868,93644,3656,6511,10889,7491,3398,11456,9034,2422,14584,10012,4572,15272,12188,3084,22.358,10.857,6.953
12089,Florida,Nassau County,78435,64294,44.9,56914,9931,5528,23688,857,1501,2878,1904,974,2593,2193,400,3592,2507,1085,3630,3060,570,27.162,9.954,6.337
12103,Florida,Pinellas County,949842,48968,47.6,722933,141166,76099,265628,9677,21479,34891,25536,9355,34718,27251,7467,46972,33166,13806,50170,40595,9575,30.053,11.729,8.086
12105,Florida,Polk County,652256,45988,40.4,448680,58147,29258,154703,5004,10772,27867,19676,8191,28352,21629,6723,34374,23288,11086,36274,27924,8350,19.48,10.198,6.963
12111,Florida,St. Lucie County,298763,47132,44.6,214460,27447,14535,79480,2724,7526,11658,8313,3345,11383,7719,3664,13815,8951,4864,14555,10674,3881,19.576,12.896,9.469
12043,Florida,Glades County,13197,37385,45.8,9894,745,332,3223,24,210,567,360,207,355,109,246,557,307,250,583,455,128,10.885,7.26,6.516
12051,Florida,Hendry County,39064,37966,33.7,24397,1298,763,7915,231,551,2055,957,1098,1504,1111,393,2402,1167,1235,2318,1235,1083,8.448,9.88,6.961
12061,Florida,Indian River County,147981,49009,52.2,112585,19263,12067,43914,1339,3311,5024,3476,1548,4620,2960,1660,5666,3488,2178,6094,4686,1408,27.828,10.589,7.54
12063,Florida,Jackson County,48571,36944,41.5,35379,2813,2142,11942,418,629,1778,1406,372,1701,1393,308,1814,1142,672,2075,1606,469,14.005,8.767,5.267
12099,Florida,Palm Beach County,1426772,57256,44.4,1037150,225909,134837,372677,15519,36793,57474,39670,17804,56585,42945,13640,73072,47375,25697,71789,53366,18423,34.782,14.037,9.873
12109,Florida,St. Johns County,226578,73640,43.1,159705,43552,25069,64505,2444,5058,8144,6646,1498,8087,6721,1366,9523,7169,2354,10369,8797,1572,42.967,11.63,7.841
12117,Florida,Seminole County,449260,60739,39.1,313146,79651,38030,106116,4962,9956,21694,17198,4496,20629,17100,3529,27369,20878,6491,28107,23193,4914,37.58,14.058,9.382
12086,Florida,Miami-Dade County,2702602,46338,39.5,1906299,339002,191194,448011,24795,61350,127812,84334,43478,124748,88036,36712,167870,107644,60226,168117,120919,47198,27.813,19.228,13.694
12005,Florida,Bay County,180117,50283,39.6,125643,18081,10004,42881,1282,3099,7817,5874,1943,7502,5576,1926,10757,7042,3715,10839,8413,2426,22.353,10.217,7.227
12035,Florida,Flagler County,105015,51049,50.3,79267,11826,6860,30369,1470,2325,3646,2458,1188,3135,2407,728,3854,2557,1297,4301,3230,1071,23.573,12.496,7.656
12037,Florida,Franklin County,11675,41267,44.3,8891,994,645,3182,114,213,500,270,230,332,237,95,495,301,194,528,335,193,18.434,10.277,6.694
12045,Florida,Gulf County,16018,44647,44.3,12127,1527,722,3953,57,290,704,646,58,389,264,125,714,312,402,457,299,158,18.545,8.778,7.336
12047,Florida,Hamilton County,14238,36209,41.1,9895,737,272,3354,118,229,602,305,297,420,298,122,290,204,86,513,467,46,10.197,10.346,6.828
12077,Florida,Liberty County,8347,36741,36.9,5655,397,233,1751,28,133,618,337,281,220,123,97,336,247,89,384,313,71,11.141,9.195,7.596
12097,Florida,Osceola County,325168,47343,35.7,212567,28215,12176,58140,3230,6565,16085,11276,4809,16171,11575,4596,20657,14787,5870,19755,15249,4506,19.002,16.847,11.292
12119,Florida,Sumter County,116754,54771,66.4,104244,18855,13373,47193,1293,3098,1361,925,436,1580,1075,505,1910,1457,453,1941,1218,723,30.916,9.304,6.565
12131,Florida,Walton County,63457,50619,43.2,46316,8178,4203,18121,721,1660,1983,1264,719,1887,1246,641,3154,1821,1333,3502,2569,933,26.732,13.139,9.161
12039,Florida,Gadsden County,46113,39830,40.7,31955,3391,1806,12159,353,676,1829,1373,456,1792,1421,371,1851,922,929,1853,1269,584,16.263,8.463,5.56
12059,Florida,Holmes County,19483,37474,42.2,13927,1121,479,5496,167,376,707,438,269,728,445,283,837,522,315,773,592,181,11.488,9.88,6.841
12065,Florida,Jefferson County,14085,47599,46,10932,1390,923,4414,150,370,233,182,51,441,420,21,385,304,81,424,378,46,21.158,11.781,8.382
12071,Florida,Lee County,700165,52052,47.8,521569,89211,52805,184567,6406,15236,24838,15942,8896,24721,17915,6806,32868,19937,12931,33457,23980,9477,27.229,11.726,8.255
12083,Florida,Marion County,343778,41964,48.5,255204,32915,16497,101514,3556,6933,12296,7460,4836,11432,8390,3042,14360,9813,4547,15469,12200,3269,19.362,10.333,6.83
12049,Florida,Hardee County,27326,39063,34.9,17288,1210,609,5288,231,155,1366,858,508,1149,806,343,1579,1109,470,1310,956,354,10.522,7.3,2.931
12021,Florida,Collier County,356774,62407,49.7,268314,55109,38621,99624,3718,8782,12697,7735,4962,11205,7264,3941,16072,9213,6859,14894,9706,5188,34.933,12.547,8.815
12093,Florida,Okeechobee County,40228,39059,41,27884,2200,862,9630,251,357,1709,942,767,1435,1036,399,2006,1233,773,1858,1452,406,10.981,6.314,3.707
12095,Florida,Orange County,1290216,51586,34.7,853821,187206,92344,246375,11398,23677,74365,55286,19079,75524,59204,16320,92220,65257,26963,92318,71770,20548,32.741,14.236,9.61
12001,Florida,Alachua County,259865,45478,31.2,156332,32960,31710,52252,1800,3360,26171,22279,3892,27774,24144,3630,16761,12661,4100,17179,15034,2145,41.367,9.875,6.43
12101,Florida,Pasco County,498136,48289,44.5,360564,54229,27566,140827,5161,9487,17213,12118,5095,17677,13451,4226,23079,15630,7449,24549,19943,4606,22.685,10.401,6.737
12041,Florida,Gilchrist County,17191,42934,42.8,11602,985,451,5229,185,290,693,410,283,529,422,107,746,459,287,810,502,308,12.377,9.084,5.546
12055,Florida,Highlands County,100177,36374,53.1,76171,8281,4772,30884,675,1577,3184,1906,1278,3055,2102,953,4202,2302,1900,3796,3028,768,17.136,7.292,5.106
12121,Florida,Suwannee County,43814,40600,41.7,30583,2955,1242,10820,356,694,1931,1044,887,2016,1875,141,2081,1742,339,2243,1765,478,13.723,9.704,6.414
12027,Florida,DeSoto County,35675,35435,40.7,25193,2002,893,8090,220,583,1847,901,946,1017,748,269,2521,1142,1379,1606,1149,457,11.491,9.926,7.206
12013,Florida,Calhoun County,14458,36237,40.3,10281,755,227,3824,129,207,464,365,99,534,421,113,577,360,217,676,530,146,9.552,8.787,5.413
12015,Florida,Charlotte County,173236,46511,58.1,141419,19864,11779,58572,2149,4654,4779,2678,2101,4870,3573,1297,5128,3316,1812,4947,3468,1479,22.375,11.615,7.946
12023,Florida,Columbia County,68484,43504,40.7,47213,5077,2674,18051,672,1248,2188,1500,688,2471,1692,779,3550,2644,906,3619,2961,658,16.417,10.637,6.914
12029,Florida,Dixie County,16323,35910,47.6,12309,782,344,5031,164,269,469,313,156,392,326,66,508,255,253,648,477,171,9.148,8.607,5.347
12085,Florida,Martin County,155719,55588,51.6,119437,23988,14595,48642,1818,3793,4959,3508,1451,4425,3695,730,6602,4042,2560,5461,4037,1424,32.304,11.535,7.798
12107,Florida,Putnam County,72435,33619,44.8,51221,4042,2358,20321,445,1524,2975,1817,1158,2767,2234,533,3032,1822,1210,3492,2486,1006,12.495,9.689,7.5
12115,Florida,Sarasota County,404839,55236,55.1,321126,64876,43904,130699,4497,9998,11528,7953,3575,11860,9186,2674,15166,10104,5062,14611,10240,4371,33.875,11.09,7.65
12125,Florida,Union County,15300,37460,39.8,11304,723,214,2673,39,266,345,265,80,366,265,101,519,430,89,662,593,69,8.289,11.41,9.951
13061,Georgia,Clay County,3024,23315,44.6,2063,61,122,747,3,62,174,25,149,95,47,48,120,67,53,130,94,36,8.871,8.701,8.3
13101,Georgia,Echols County,4011,34315,38.1,2631,127,54,932,3,36,188,87,101,57,30,27,196,86,110,208,160,48,6.88,4.185,3.863
13127,Georgia,Glynn County,83467,47546,40.8,57587,10305,6370,20351,816,1453,3345,2466,879,3601,2556,1045,4214,2805,1409,4826,3341,1485,28.956,11.149,7.14
13089,Georgia,DeKalb County,736066,55876,35.5,497255,121254,88288,147910,6658,13874,32895,23001,9894,35636,27301,8335,51926,35899,16027,57498,44436,13062,42.14,13.881,9.38
13143,Georgia,Haralson County,28722,43663,40.7,19468,1533,1215,7535,229,442,1099,646,453,1227,924,303,1534,1072,462,1531,1288,243,14.115,8.905,5.866
13181,Georgia,Lincoln County,7768,37711,47.9,5687,449,238,2496,52,161,296,260,36,245,194,51,337,194,143,366,269,97,12.08,8.534,6.45
13157,Georgia,Jackson County,63851,57999,38.7,42968,5506,2956,16780,577,1201,2151,1846,305,2139,1517,622,3687,2726,961,3694,2710,984,19.694,10.596,7.157
13163,Georgia,Jefferson County,15954,29640,38.6,10706,805,331,3726,75,316,659,393,266,758,535,223,819,413,406,858,567,291,10.611,10.494,8.481
13169,Georgia,Jones County,28540,55110,39.7,19462,2393,1645,8437,199,413,1014,571,443,1027,806,221,1419,990,429,1569,1347,222,20.748,7.254,4.895
13213,Georgia,Murray County,39444,41617,37.6,26017,1448,1050,9620,289,448,1759,1125,634,1770,1199,571,2072,1566,506,2253,1747,506,9.601,7.661,4.657
13215,Georgia,Muscogee County,198647,43239,33.7,127882,20489,12718,35455,1358,3137,8307,5727,2580,10100,7936,2164,11944,8498,3446,13891,11511,2380,25.967,12.678,8.848
13235,Georgia,Pulaski County,11396,38750,43.1,8466,570,495,2384,77,145,626,494,132,325,264,61,394,254,140,499,290,209,12.58,9.312,6.082
13241,Georgia,Rabun County,16354,39297,48.8,12302,1741,1372,4824,214,385,659,371,288,478,313,165,728,292,436,735,432,303,25.305,12.417,7.981
13259,Georgia,Stewart County,5832,22413,37,4316,416,119,1211,5,128,176,92,84,188,165,23,222,70,152,243,177,66,12.396,10.983,10.57
13281,Georgia,Towns County,11173,41182,53.3,8133,1232,850,3708,95,462,676,578,98,609,522,87,308,262,46,377,310,67,25.599,15.022,12.46
13283,Georgia,Treutlen County,6752,39375,40.8,4764,455,284,1870,36,115,159,93,66,297,256,41,338,175,163,405,264,141,15.512,8.075,6.15
13287,Georgia,Turner County,8036,42622,40.2,5555,473,277,2169,35,105,223,125,98,218,177,41,260,146,114,491,372,119,13.501,6.455,4.841
13155,Georgia,Irwin County,9278,34677,39.7,6360,410,424,2507,72,74,427,205,222,423,287,136,581,241,340,305,203,102,13.113,5.824,2.952
13003,Georgia,Atkinson County,8313,33063,34.9,5242,252,176,2100,49,65,395,263,132,351,227,124,535,325,210,445,234,211,8.165,5.429,3.095
13001,Georgia,Appling County,18471,37089,39.3,12366,819,606,4816,38,140,644,364,280,666,452,214,978,554,424,1004,602,402,11.524,3.696,2.907
13005,Georgia,Bacon County,11279,38824,37.6,7454,535,344,2821,25,208,321,226,95,411,241,170,480,251,229,621,420,201,11.792,8.259,7.373
13025,Georgia,Brantley County,18411,36812,40.3,12397,543,429,5212,114,278,723,431,292,734,429,305,955,626,329,924,627,297,7.841,7.521,5.334
13313,Georgia,Whitfield County,103963,43871,35.4,66225,6158,3488,21835,448,1268,5060,3427,1633,4850,3451,1399,6161,3733,2428,5963,3718,2245,14.565,7.859,5.807
13037,Georgia,Calhoun County,6503,29617,38.4,4864,290,169,1257,31,34,108,42,66,172,140,32,225,120,105,312,229,83,9.437,5.171,2.705
13193,Georgia,Macon County,13675,30851,40.6,9658,504,326,2935,79,140,466,349,117,420,269,151,493,200,293,495,275,220,8.594,7.462,4.77
13285,Georgia,Troup County,69433,43597,36.2,44844,5136,3182,14074,458,1201,3149,2204,945,3890,2863,1027,3758,2627,1131,3838,2799,1039,18.549,11.788,8.533
13021,Georgia,Bibb County,153923,38183,36,99658,14848,10416,30235,1297,2147,6742,4405,2337,8460,6320,2140,8365,5465,2900,9636,7324,2312,25.351,11.391,7.101
13145,Georgia,Harris County,33198,69539,43.2,23065,3813,2497,10240,542,490,1227,1002,225,1155,1055,100,1399,1123,276,1416,1212,204,27.357,10.078,4.785
13197,Georgia,Marion County,8558,39015,43.3,6102,426,335,2366,105,139,327,200,127,268,249,19,460,232,228,372,317,55,12.471,10.313,5.875
13249,Georgia,Schley County,5168,41267,36.9,3346,271,187,1268,39,64,233,180,53,218,163,55,324,236,88,285,192,93,13.688,8.123,5.047
13321,Georgia,Worth County,20809,40369,42.1,14137,954,605,5343,151,242,826,452,374,788,542,246,1076,722,354,1215,808,407,11.028,7.355,4.529
13023,Georgia,Bleckley County,12779,40688,37.4,8035,748,633,2978,102,111,877,690,187,798,661,137,441,287,154,689,552,137,17.187,7.152,3.727
13093,Georgia,Dooly County,14053,33389,43.5,10097,675,327,3325,152,231,702,420,282,461,294,167,404,236,168,471,373,98,9.924,11.519,6.947
13109,Georgia,Evans County,10757,38736,37.3,7155,714,397,2598,27,171,300,239,61,309,121,188,568,377,191,711,476,235,15.528,7.621,6.582
13119,Georgia,Franklin County,22328,39246,41.1,15254,1243,709,5623,160,449,1007,688,319,956,582,374,1203,776,427,1266,985,281,12.797,10.831,7.985
13307,Georgia,Webster County,2627,36658,43.5,1804,116,87,851,20,51,86,86,0,102,69,33,160,160,0,126,98,28,11.253,8.343,5.993
13103,Georgia,Effingham County,57087,64279,36.2,36802,4802,2278,15028,551,883,2412,1744,668,2151,1727,424,3200,2373,827,3482,2752,730,19.238,9.542,5.876
13171,Georgia,Lamar County,18282,41157,38.1,11670,1499,648,4339,293,310,1091,791,300,1234,937,297,655,440,215,925,649,276,18.398,13.897,7.145
13125,Georgia,Glascock County,3027,45273,42.9,2067,148,46,855,23,31,120,98,22,137,118,19,124,75,49,95,40,55,9.386,6.316,3.626
13107,Georgia,Emanuel County,22502,33089,37.2,14815,1001,849,5719,163,332,1063,505,558,886,453,433,1085,557,528,1345,935,410,12.487,8.655,5.805
13239,Georgia,Quitman County,2140,26750,52.6,1658,87,51,725,25,68,68,37,31,46,30,16,134,76,58,76,31,45,8.323,12.828,9.379
13051,Georgia,Chatham County,285506,52215,34.9,189667,38595,24463,57915,2204,5028,15357,10918,4439,16836,12392,4444,18576,12523,6053,20757,16003,4754,33.247,12.487,8.682
13179,Georgia,Liberty County,62120,43493,27.9,35487,4787,2114,10356,397,1025,2926,2056,870,4070,3428,642,3839,2861,978,4552,3652,900,19.447,13.731,9.898
13159,Georgia,Jasper County,13732,42067,42.2,9416,539,450,3747,177,435,468,351,117,606,543,63,645,297,348,683,436,247,10.503,16.333,11.609
13167,Georgia,Johnson County,9800,36423,41.6,6970,418,250,2310,56,112,541,335,206,313,185,128,549,426,123,250,170,80,9.584,7.273,4.848
13173,Georgia,Lanier County,10388,31109,33.8,6829,724,352,2306,86,288,522,314,208,464,250,214,489,287,202,853,723,130,15.756,16.219,12.489
13195,Georgia,Madison County,28600,47653,41,19636,1827,1456,7833,189,376,1371,863,508,1222,993,229,1210,856,354,1450,1010,440,16.719,7.213,4.8
13205,Georgia,Mitchell County,22574,34122,38.8,15298,1270,611,5267,187,375,769,366,403,815,511,304,899,679,220,1192,797,395,12.296,10.67,7.12
13253,Georgia,Seminole County,8549,33999,44,5940,554,341,2380,79,174,298,112,186,332,214,118,391,249,142,357,260,97,15.067,10.63,7.311
13277,Georgia,Tift County,40531,38728,35.5,25690,2154,2166,8545,324,704,2274,1598,676,2252,1468,784,2139,1165,974,2416,1816,600,16.816,12.03,8.239
13289,Georgia,Twiggs County,8323,30629,46.3,6007,350,205,2311,58,121,389,220,169,406,301,105,342,183,159,320,250,70,9.239,7.746,5.236
13233,Georgia,Polk County,41444,40652,37.1,27250,2045,1413,9646,434,523,1646,1116,530,1614,1144,470,2375,1280,1095,2459,1978,481,12.69,9.921,5.422
13263,Georgia,Talbot County,6423,37226,49.9,4775,393,203,2262,104,147,181,121,60,225,146,79,215,185,30,152,102,50,12.482,11.096,6.499
13269,Georgia,Taylor County,8267,29875,43.8,5741,419,233,2471,96,143,338,77,261,342,229,113,314,194,120,379,238,141,11.357,9.672,5.787
13273,Georgia,Terrell County,8978,32219,40.7,6069,351,304,1925,36,194,284,87,197,347,265,82,406,236,170,454,263,191,10.793,11.948,10.078
13275,Georgia,Thomas County,44909,41336,39.6,30451,3643,3114,11116,314,973,1755,1013,742,1874,1429,445,2198,1620,578,2621,1812,809,22.19,11.578,8.753
13279,Georgia,Toombs County,27160,35750,36.1,17485,1709,1063,6371,165,329,1176,577,599,1093,620,473,1469,929,540,1750,1091,659,15.854,7.754,5.164
13319,Georgia,Wilkinson County,9147,38711,42.5,6253,345,216,2518,43,76,382,316,66,393,311,82,372,235,137,445,332,113,8.972,4.726,3.018
13017,Georgia,Ben Hill County,17272,32344,39,11412,709,459,3861,139,358,626,327,299,739,514,225,796,572,224,877,619,258,10.235,12.872,9.272
13033,Georgia,Burke County,22645,38707,37.4,14663,1046,669,5587,131,274,922,548,374,978,646,332,1206,824,382,1304,1090,214,11.696,7.249,4.904
13047,Georgia,Catoosa County,65870,54537,39.6,45081,6169,2965,18140,435,1067,2605,1892,713,2904,2320,584,3422,2482,940,3668,2742,926,20.261,8.28,5.882
13053,Georgia,Chattahoochee County,11096,46096,23.7,4948,1224,409,675,18,28,407,243,164,379,327,52,385,337,48,516,468,48,33.003,6.815,4.148
13055,Georgia,Chattooga County,24880,35718,40.3,17190,1015,720,6077,104,330,848,589,259,919,648,271,1037,643,394,1193,861,332,10.093,7.142,5.43
13073,Georgia,Columbia County,143723,74162,36.4,94536,20098,12419,35992,901,1907,5672,4872,800,5908,4737,1171,7154,5697,1457,8866,7783,1083,34.396,7.802,5.298
13087,Georgia,Decatur County,27023,36934,37.9,17863,1447,1211,6157,210,451,1006,499,507,1128,947,181,1193,692,501,1502,1082,420,14.88,10.736,7.325
13115,Georgia,Floyd County,96471,46096,38.3,63693,7793,5254,21371,640,1326,4428,3049,1379,5071,3999,1072,5058,3447,1611,5165,4102,1063,20.484,9.199,6.205
13117,Georgia,Forsyth County,211300,96445,38.2,136116,45515,22764,59379,1927,3779,6470,5241,1229,6192,5138,1054,9276,6954,2322,10182,8360,1822,50.162,9.609,6.364
13137,Georgia,Habersham County,43878,44474,39.5,29498,2982,2431,11361,348,828,2047,1569,478,1779,1283,496,2104,1064,1040,1971,1496,475,18.35,10.351,7.288
13147,Georgia,Hart County,25535,41216,43,18073,1502,984,7357,287,457,1099,715,384,1026,789,237,1140,927,213,1114,875,239,13.755,10.113,6.212
13185,Georgia,Lowndes County,113941,39911,30.1,66466,9903,6877,21035,701,1423,8170,5331,2839,9833,7485,2348,6503,4350,2153,6866,5117,1749,25.246,10.097,6.765
13191,Georgia,McIntosh County,14061,43285,49.2,10558,877,597,4513,77,458,386,297,89,643,575,68,652,473,179,541,220,321,13.961,11.855,10.148
13199,Georgia,Meriwether County,21152,36368,42,14731,943,627,5533,118,274,816,627,189,823,603,220,999,688,311,1120,780,340,10.658,7.085,4.952
13207,Georgia,Monroe County,26795,50666,43.3,18924,2322,1972,7398,224,603,1063,816,247,956,735,221,1274,888,386,1171,965,206,22.691,11.179,8.151
13237,Georgia,Putnam County,21430,48340,45.6,15663,2284,1074,6490,213,525,767,461,306,725,353,372,1101,519,582,1130,824,306,21.439,11.371,8.089
13261,Georgia,Sumter County,30687,34219,35.2,19209,1683,1544,6626,130,473,1769,931,838,2118,1695,423,1450,1021,429,1630,1302,328,16.799,9.101,7.139
13265,Georgia,Taliaferro County,1844,30500,43.3,1361,75,18,495,17,42,119,98,21,68,49,19,123,72,51,87,79,8,6.833,11.919,8.485
13301,Georgia,Warren County,5410,32860,44.2,3962,336,208,1526,20,128,196,133,63,126,52,74,299,219,80,334,192,142,13.73,9.699,8.388
13007,Georgia,Baker County,3251,43867,43.6,2308,138,117,916,70,36,82,56,26,191,152,39,220,85,135,115,91,24,11.049,11.572,3.93
13029,Georgia,Bryan County,34883,68589,34.8,21990,4517,2617,8515,233,851,1346,907,439,1317,1042,275,1731,1284,447,2114,1619,495,32.442,12.73,9.994
13035,Georgia,Butts County,23556,39655,38.4,16454,1169,563,5628,228,361,862,523,339,811,618,193,1189,932,257,1261,1005,256,10.526,10.466,6.414
13043,Georgia,Candler County,10894,33125,37.9,7228,681,361,2373,98,146,448,236,212,456,311,145,539,302,237,542,284,258,14.416,10.282,6.153
13039,Georgia,Camden County,52252,53687,31.6,32402,4836,2810,11358,387,802,2545,1584,961,2867,2327,540,2767,1721,1046,3066,2570,496,23.597,10.468,7.061
13045,Georgia,Carroll County,114898,46844,34.4,71749,8691,5377,26355,1038,1906,7070,5336,1734,7932,6807,1125,6528,4325,2203,6120,4878,1242,19.607,11.171,7.232
13079,Georgia,Crawford County,12385,41032,44.2,8781,652,507,3622,109,327,521,430,91,376,295,81,619,420,199,628,527,101,13.199,12.038,9.028
13099,Georgia,Early County,10405,29493,40.5,6965,699,483,2747,65,241,390,153,237,417,279,138,430,188,242,521,447,74,16.971,11.139,8.773
13081,Georgia,Crisp County,23005,33194,38.3,15148,1286,775,4909,88,406,1068,583,485,1084,864,220,997,605,392,1282,948,334,13.606,10.063,8.271
13069,Georgia,Coffee County,43048,36572,35.9,27849,2373,1549,9468,516,615,2022,1444,578,2110,1147,963,2045,989,1056,2252,1375,877,14.083,11.946,6.496
13077,Georgia,Coweta County,138015,67570,37.9,91386,18032,8504,36672,1005,2447,5475,4287,1188,5739,4719,1020,7211,5359,1852,7689,6454,1235,29.037,9.413,6.673
13067,Georgia,Cobb County,739072,72004,36.4,490883,145159,78193,176516,6055,12115,34454,25608,8846,33926,26518,7408,45327,33288,12039,48735,38032,10703,45.5,10.294,6.863
13123,Georgia,Gilmer County,29614,46211,46,21559,2494,1511,8537,376,536,1120,636,484,882,646,236,1345,570,775,1406,785,621,18.577,10.683,6.279
13083,Georgia,Dade County,16282,43163,41.8,11143,1013,539,4584,169,224,964,826,138,960,795,165,698,412,286,769,654,115,13.928,8.573,4.887
13297,Georgia,Walton County,88695,55876,38.9,58380,7718,3356,22243,928,1614,4091,2615,1476,3845,2732,1113,4071,2948,1123,4592,3732,860,18.969,11.428,7.256
13317,Georgia,Wilkes County,9905,34234,45.5,6979,541,458,2689,67,179,357,203,154,396,265,131,543,282,261,403,273,130,14.314,9.148,6.657
13027,Georgia,Brooks County,15629,34890,43.2,11034,1056,442,4661,194,389,523,296,227,621,300,321,807,421,386,738,649,89,13.576,12.508,8.346
13091,Georgia,Dodge County,21063,35290,41.2,14874,1261,914,5200,188,170,1104,651,453,883,603,280,974,788,186,943,680,263,14.623,6.885,3.269
13129,Georgia,Gordon County,56424,43452,37,37612,3033,2114,12818,269,974,2541,1612,929,2040,1548,492,2913,1977,936,3578,2437,1141,13.684,9.697,7.599
13105,Georgia,Elbert County,19288,35207,42.3,13469,856,633,5580,273,314,819,538,281,807,549,258,949,620,329,975,652,323,11.055,10.52,5.627
13057,Georgia,Cherokee County,235896,75477,38,156284,38336,17427,63549,1914,5196,8992,7047,1945,9408,7100,2308,12727,9128,3599,12483,10080,2403,35.681,11.188,8.176
13113,Georgia,Fayette County,110306,84861,43.5,74267,21811,12869,32077,1037,2412,4112,3437,675,4315,3599,716,4236,3450,786,4142,3475,667,46.696,10.752,7.519
13165,Georgia,Jenkins County,8929,27197,40.6,5838,294,188,2317,38,81,456,308,148,422,332,90,365,190,175,405,204,201,8.256,5.136,3.496
13177,Georgia,Lee County,29216,65018,36.9,19114,2881,2027,7546,214,460,1098,756,342,976,902,74,1434,1055,379,1695,1279,416,25.678,8.932,6.096
13217,Georgia,Newton County,105042,52784,36.2,66904,8455,4848,24729,1007,2159,4752,3213,1539,4506,3355,1151,5168,4021,1147,6226,4883,1343,19.884,12.803,8.731
13227,Georgia,Pickens County,30343,61542,44.9,22087,3479,2013,8825,305,506,1069,845,224,1103,830,273,1447,924,523,1463,1036,427,24.865,9.19,5.734
13133,Georgia,Greene County,16732,45069,48.9,12443,1733,1453,4901,212,480,510,329,181,492,321,171,777,335,442,857,394,463,25.605,14.12,9.794
13071,Georgia,Colquitt County,45890,34503,36,29544,2089,1616,9277,289,547,2006,810,1196,1844,1061,783,2530,1100,1430,2716,1419,1297,12.541,9.012,5.896
13075,Georgia,Cook County,17190,35539,37,11247,1048,617,4185,256,384,799,453,346,731,361,370,874,538,336,983,652,331,14.804,15.293,9.176
13085,Georgia,Dawson County,23397,62284,43.3,16644,3226,1947,6827,223,542,843,716,127,878,619,259,1193,850,343,982,664,318,31.08,11.206,7.939
13141,Georgia,Hancock County,8667,29268,44.3,6709,330,254,2331,134,193,174,157,17,44,30,14,139,109,30,231,162,69,8.705,14.028,8.28
13063,Georgia,Clayton County,274150,44106,32.4,168512,21663,10490,46220,2025,4491,13788,8290,5498,14627,9916,4711,16149,8698,7451,19293,13303,5990,19.081,14.098,9.717
13121,Georgia,Fulton County,1010420,61336,35.2,674996,201680,137060,201145,6983,17649,53684,42874,10810,53660,44084,9576,70723,53876,16847,76055,62499,13556,50.184,12.246,8.774
13139,Georgia,Hall County,192865,55622,36,124695,18303,11004,42572,1745,2882,9733,6735,2998,8452,5810,2642,10862,6415,4447,11073,7241,3832,23.503,10.869,6.77
13187,Georgia,Lumpkin County,31567,43039,37.3,19786,2977,2297,7321,252,490,2720,2194,526,2533,2110,423,1413,1155,258,1531,1317,214,26.655,10.135,6.693
13189,Georgia,McDuffie County,21488,40469,37.8,14103,1363,793,5008,205,306,790,559,231,884,536,348,948,535,413,1187,879,308,15.288,10.204,6.11
13201,Georgia,Miller County,5884,37255,43.1,4095,313,153,1535,25,46,234,141,93,183,96,87,228,173,55,312,256,56,11.38,4.625,2.997
13211,Georgia,Morgan County,18013,59572,44.2,12387,1671,1062,5003,174,375,758,424,334,561,348,213,540,426,114,935,745,190,22.063,10.973,7.496
13149,Georgia,Heard County,11607,44897,41.9,7914,488,363,3046,39,178,489,382,107,543,279,264,500,312,188,530,345,185,10.753,7.124,5.844
13219,Georgia,Oconee County,35972,77388,40.1,23495,5398,5927,10432,434,612,1348,1171,177,1078,942,136,1314,986,328,1631,1373,258,48.202,10.027,5.867
13095,Georgia,Dougherty County,91522,34541,35,58166,6848,5207,15728,476,1239,4533,2748,1785,5836,3438,2398,4660,2365,2295,5671,4176,1495,20.725,10.904,7.878
13111,Georgia,Fannin County,24480,43344,50.8,18656,2216,1331,7817,216,602,796,589,207,593,438,155,807,592,215,1063,795,268,19.013,10.464,7.701
13151,Georgia,Henry County,217506,64752,36.7,138840,24882,13939,52337,2121,5089,9677,7618,2059,9831,7771,2060,10121,7718,2403,11935,9691,2244,27.961,13.776,9.724
13153,Georgia,Houston County,150341,55965,35.1,97589,15147,9612,35396,793,1725,6668,4725,1943,6494,4861,1633,8875,6356,2519,10321,8063,2258,25.371,7.114,4.873
13175,Georgia,Laurens County,47451,35202,38.3,31623,2645,2240,10956,242,420,1848,1080,768,2104,1513,591,2325,1673,652,2760,2074,686,15.448,6.042,3.834
13183,Georgia,Long County,17857,53083,31.6,10865,1093,598,3708,120,181,963,554,409,740,532,208,1048,668,380,1428,952,476,15.564,8.118,4.881
13255,Georgia,Spalding County,64192,42398,38.9,43193,4527,2471,14404,586,1261,2877,1581,1296,2718,1983,735,3218,1971,1247,3715,2848,867,16.202,12.823,8.755
13257,Georgia,Stephens County,25625,39756,42.3,17196,1824,1550,6620,193,315,1281,853,428,1177,899,278,1240,874,366,1292,971,321,19.621,7.674,4.758
13271,Georgia,Telfair County,16339,28044,41,12318,513,485,3191,59,76,272,253,19,496,336,160,881,700,181,655,526,129,8.102,4.231,2.382
13291,Georgia,Union County,22262,42767,53.8,17387,2091,1733,7041,140,415,590,532,58,568,424,144,770,377,393,774,457,317,21.993,7.882,5.894
13293,Georgia,Upson County,26241,35375,41.5,18022,1425,903,6600,168,373,1091,663,428,1221,817,404,1154,813,341,1151,863,288,12.918,8.197,5.652
13303,Georgia,Washington County,20506,38097,40.3,14069,1244,596,5080,58,362,784,518,266,818,539,279,905,551,354,1028,822,206,13.078,8.268,7.126
13311,Georgia,White County,28509,43944,45.1,20066,2396,1663,8227,233,688,1194,840,354,1317,1050,267,1205,904,301,1072,641,431,20.228,11.195,8.363
13225,Georgia,Peach County,27027,43645,35.8,17205,2049,1444,6639,191,457,1830,1419,411,1734,1288,446,1404,932,472,1489,1009,480,20.302,9.761,6.884
13223,Georgia,Paulding County,152399,63669,35.6,97288,15601,8110,39939,1263,3047,6195,5142,1053,6338,5097,1241,8566,6675,1891,9154,7307,1847,24.372,10.791,7.629
13229,Georgia,Pierce County,19141,39863,39.4,12969,851,792,5123,70,264,749,543,206,573,395,178,983,671,312,1085,707,378,12.669,6.52,5.153
13231,Georgia,Pike County,17919,52377,40.5,12147,1346,655,4968,151,496,710,496,214,733,639,94,841,528,313,913,666,247,16.473,13.023,9.984
13245,Georgia,Richmond County,201568,39430,33.7,130545,16928,10543,38434,1375,3185,10274,7531,2743,11559,8616,2943,11964,7646,4318,13934,10968,2966,21.043,11.864,8.287
13251,Georgia,Screven County,14037,36556,41.2,9671,919,505,3643,166,225,574,338,236,543,480,63,588,442,146,792,525,267,14.724,10.733,6.176
13267,Georgia,Tattnall County,25402,36355,36.9,17799,1310,874,5487,134,375,648,425,223,540,434,106,696,401,295,1182,854,328,12.27,9.276,6.834
13019,Georgia,Berrien County,19014,38297,39.5,12923,943,571,5017,72,290,757,400,357,778,408,370,951,419,532,962,634,328,11.716,7.215,5.78
13295,Georgia,Walker County,68609,43581,41.4,48020,4981,2457,18475,507,874,2554,1830,724,2473,1682,791,3519,2395,1124,3759,2844,915,15.489,7.475,4.731
13135,Georgia,Gwinnett County,889954,64496,34.9,562979,131038,67782,188529,8669,16703,40440,27073,13367,39491,28861,10630,51661,32222,19439,54166,38127,16039,35.316,13.458,8.86
13013,Georgia,Barrow County,75099,56119,35.1,48812,5756,2665,17930,574,1299,2832,1938,894,3034,1960,1074,5156,3573,1583,5137,3926,1211,17.252,10.446,7.245
13049,Georgia,Charlton County,12963,43257,41.4,8975,250,520,2566,28,157,801,661,140,624,399,225,512,270,242,514,236,278,8.579,7.21,6.118
13065,Georgia,Clinch County,6788,21838,37.6,4475,335,214,1840,58,77,199,172,27,293,160,133,356,228,128,449,198,251,12.268,7.337,4.185
13015,Georgia,Bartow County,102623,52393,37.5,68263,8715,4513,24293,796,1849,4473,3244,1229,4055,3094,961,5561,3792,1769,6196,4749,1447,19.378,10.888,7.611
13097,Georgia,Douglas County,140152,59333,36.3,90072,14692,9344,31884,1249,2776,6059,4244,1815,6157,4963,1194,7206,4550,2656,8299,5981,2318,26.685,12.624,8.707
13131,Georgia,Grady County,25048,39462,39.7,16885,1418,899,5548,136,306,800,531,269,1048,608,440,1623,869,754,1393,838,555,13.722,7.967,5.516
13161,Georgia,Jeff Davis County,14999,37267,36.3,9716,579,422,3820,34,185,372,265,107,635,446,189,687,224,463,948,558,390,10.303,5.733,4.843
13209,Georgia,Montgomery County,8962,40308,39.4,5966,525,399,2261,54,119,528,442,86,437,338,99,323,263,60,396,324,72,15.488,7.651,5.263
13221,Georgia,Oglethorpe County,14654,43938,42.5,10457,999,627,4387,90,398,456,378,78,395,307,88,773,574,199,807,658,149,15.549,11.124,9.072
13243,Georgia,Randolph County,7206,30640,44.3,4982,344,258,1732,49,154,190,81,109,177,104,73,409,136,273,263,174,89,12.084,11.721,8.891
13247,Georgia,Rockdale County,88482,54175,37.3,57669,9998,4862,20520,1065,1935,3834,2546,1288,3774,2707,1067,4266,2898,1368,4921,3237,1684,25.768,14.62,9.43
13299,Georgia,Ware County,35688,36962,38.9,24214,1912,1347,8777,183,423,1267,774,493,1459,972,487,1743,1288,455,1861,1373,488,13.459,6.904,4.819
13305,Georgia,Wayne County,29833,41534,38.2,20139,1504,1058,6537,197,325,1010,770,240,1103,828,275,1601,970,631,1768,1132,636,12.722,7.985,4.972
13309,Georgia,Wheeler County,7952,28490,38.2,5426,381,57,1259,50,36,484,398,86,219,99,120,283,155,128,236,107,129,8.072,6.831,2.859
13315,Georgia,Wilcox County,8896,35457,39.4,6390,390,282,1956,77,80,259,168,91,240,141,99,293,219,74,400,216,184,10.516,8.027,4.09
13009,Georgia,Baldwin County,45527,37008,35.1,28061,3013,2426,9004,255,589,3665,3167,498,4062,3403,659,2163,1469,694,2202,1860,342,19.383,9.374,6.542
13011,Georgia,Banks County,18363,42182,40.3,12610,923,580,4816,246,355,765,436,329,619,431,188,881,697,184,1084,852,232,11.919,12.479,7.371
13031,Georgia,Bulloch County,73742,39305,28.1,40497,6282,5007,14157,387,893,8491,7212,1279,7645,6304,1341,4057,2782,1275,4296,3193,1103,27.876,9.041,6.308
13059,Georgia,Clarke County,123554,34557,27.3,68176,14124,14015,17832,559,1479,15310,13238,2072,16145,14037,2108,8287,5954,2333,8993,6685,2308,41.274,11.429,8.294
15001,Hawaii,Hawaii County,196325,56395,42.1,138132,26418,13086,44942,1894,4683,7506,6634,872,7447,6718,729,10644,8891,1753,10694,9826,868,28.599,14.634,10.42
15003,Hawaii,Honolulu County,990060,80078,37.6,679932,152164,79006,173242,9318,16974,42776,38898,3878,42941,40069,2872,57699,52362,5337,62008,58469,3539,33.999,15.176,9.798
15009,Hawaii,Maui County,164094,72762,40.9,115902,20711,9748,32223,1722,4683,6340,5490,850,5811,5195,616,9432,8202,1230,9645,8818,827,26.28,19.877,14.533
15007,Hawaii,Kauai County,71093,72330,42.1,50275,9793,4406,14213,819,1800,2570,2075,495,2667,2467,200,3990,3386,604,3707,3454,253,28.243,18.427,12.664
15005,Hawaii,Kalawao County,86,61750,57.6,79,11,7,2,0,0,2,2,0,3,3,0,4,4,0,0,0,0,22.785,0,0
16071,Idaho,Oneida County,4284,43491,39.5,2643,300,100,1243,51,134,167,118,49,172,129,43,156,108,48,123,82,41,15.134,14.883,10.78
16031,Idaho,Cassia County,23472,48162,31.8,13738,1786,705,5455,231,254,1002,693,309,947,681,266,1284,705,579,1187,888,299,18.132,8.891,4.656
16045,Idaho,Gem County,16850,42888,45.2,11696,1355,616,4788,196,363,596,292,304,488,399,89,742,447,295,732,510,222,16.852,11.675,7.581
16063,Idaho,Lincoln County,5296,46383,33.1,3237,222,72,1115,58,68,217,146,71,186,157,29,311,183,128,335,167,168,9.082,11.3,6.099
16085,Idaho,Valley County,10104,54015,50.2,7748,1705,679,2673,100,260,335,284,51,81,79,2,281,116,165,341,249,92,30.769,13.468,9.727
16003,Idaho,Adams County,3946,42727,52.8,3041,359,257,1386,76,53,107,57,50,78,48,30,107,81,26,146,88,58,20.256,9.307,3.824
16041,Idaho,Franklin County,13120,51583,32.6,7619,1085,453,3449,115,251,437,347,90,488,370,118,678,474,204,624,487,137,20.186,10.612,7.277
16069,Idaho,Nez Perce County,40014,51804,41.3,27742,4538,1748,11555,317,464,1811,1544,267,1936,1611,325,2274,1797,477,2182,1806,376,22.659,6.759,4.016
16053,Idaho,Jerome County,23039,46421,32.6,13837,1299,506,4963,163,382,1079,481,598,1049,735,314,1383,913,470,1256,782,474,13.045,10.981,7.697
16055,Idaho,Kootenai County,150128,53189,39.7,102732,17039,8177,41729,1541,3205,6495,5154,1341,5527,4181,1346,7646,5666,1980,8543,6850,1693,24.545,11.373,7.681
16061,Idaho,Lewis County,3824,40313,48.1,2692,329,111,1201,33,89,112,77,35,98,68,30,135,96,39,168,113,55,16.345,10.158,7.41
16067,Idaho,Minidoka County,20448,48021,35.4,12715,1272,530,5227,158,209,1037,508,529,892,501,391,1030,632,398,996,618,378,14.172,7.021,3.998
16083,Idaho,Twin Falls County,82248,49118,34.6,52179,6656,3326,20461,657,1256,3715,2704,1011,3600,2716,884,4855,3842,1013,5209,4010,1199,19.13,9.349,6.139
16073,Idaho,Owyhee County,11384,36092,38.6,7334,555,155,2865,174,190,496,246,250,398,267,131,459,302,157,551,317,234,9.681,12.705,6.632
16013,Idaho,Blaine County,21583,58835,42.8,15157,4166,1954,5528,304,692,670,520,150,697,495,202,1126,666,460,1012,652,360,40.377,18.017,12.518
16015,Idaho,Boise County,6968,49964,53.2,5350,1026,534,2490,85,231,163,111,52,91,73,18,203,112,91,205,156,49,29.159,12.691,9.277
16021,Idaho,Boundary County,11323,39512,43.7,7869,1029,403,3317,107,228,359,301,58,365,213,152,474,316,158,455,247,208,18.198,10.099,6.874
16023,Idaho,Butte County,2613,43207,46.4,1897,227,67,870,21,76,33,14,19,64,56,8,119,49,70,83,78,5,15.498,11.149,8.736
16029,Idaho,Caribou County,6862,58750,36.9,4413,675,211,2124,28,89,217,183,34,201,184,17,364,282,82,385,325,60,20.077,5.508,4.19
16047,Idaho,Gooding County,15110,42626,37.3,9639,984,433,3764,73,257,565,327,238,452,282,170,833,551,282,775,550,225,14.701,8.767,6.828
16001,Idaho,Ada County,435117,60151,36.4,289374,73092,35811,112238,4008,7277,19162,15807,3355,18330,15625,2705,27069,21794,5275,27279,23401,3878,37.634,10.055,6.484
16005,Idaho,Bannock County,84113,47390,33.2,52599,9807,4949,21200,643,1062,4579,3899,680,4476,3866,610,5612,4383,1229,5270,4534,736,28.054,8.042,5.009
16007,Idaho,Bear Lake County,5942,50603,39.3,3904,646,146,1817,31,119,210,172,38,223,185,38,292,279,13,272,256,16,20.287,8.255,6.549
16011,Idaho,Bingham County,45369,51307,33.3,27152,3747,1485,11147,312,432,1938,1539,399,1883,1421,462,2250,1616,634,2444,1736,708,19.269,6.674,3.875
16019,Idaho,Bonneville County,110404,54150,32.6,66489,13665,5808,27120,843,1433,4488,3325,1163,4662,3982,680,6685,5267,1418,6825,5716,1109,29.288,8.392,5.284
16025,Idaho,Camas County,886,36667,47,611,91,35,272,4,53,16,10,6,39,16,23,26,24,2,18,18,0,20.622,20.956,19.485
16027,Idaho,Canyon County,207027,46426,33.2,125936,16252,6492,46834,2120,3251,9434,6170,3264,9522,6903,2619,11743,8331,3412,12375,9306,3069,18.06,11.468,6.942
16035,Idaho,Clearwater County,8533,41122,50.3,6659,824,334,2848,75,126,223,134,89,168,134,34,273,198,75,266,207,59,17.39,7.058,4.424
16051,Idaho,Jefferson County,27410,58055,31.3,15686,2398,934,6861,236,389,943,825,118,1136,920,216,1588,1174,414,1470,1161,309,21.242,9.109,5.67
16057,Idaho,Latah County,38697,43310,28.3,21464,5765,4203,8230,262,378,5040,4842,198,4344,3966,378,2447,2035,412,2117,1806,311,46.441,7.776,4.593
16037,Idaho,Custer County,4141,37976,53.4,3235,511,220,1410,46,44,152,130,22,68,61,7,77,45,32,144,93,51,22.597,6.383,3.121
16059,Idaho,Lemhi County,7755,36031,52.9,5950,934,393,2611,55,231,238,47,191,159,159,0,298,207,91,339,247,92,22.303,10.954,8.847
16075,Idaho,Payette County,22839,48447,38.8,14877,1546,564,6342,190,472,944,542,402,771,565,206,1159,878,281,1222,925,297,14.183,10.438,7.442
16009,Idaho,Benewah County,9050,43472,46.5,6422,617,286,2596,111,177,313,187,126,225,168,57,339,294,45,376,329,47,14.061,11.094,6.818
16017,Idaho,Bonner County,41855,45607,47.7,30832,4627,2293,12782,713,1258,1342,784,558,1099,808,291,1608,1200,408,1763,1282,481,22.444,15.42,9.842
16033,Idaho,Clark County,1055,31927,29.7,587,65,35,173,17,20,78,9,69,27,16,11,79,56,23,80,66,14,17.036,21.387,11.561
16039,Idaho,Elmore County,26232,45154,31.4,16039,2046,777,5823,128,314,1111,879,232,1370,1055,315,1453,1077,376,1554,1293,261,17.601,7.591,5.392
16043,Idaho,Fremont County,12889,51806,36.7,8210,1220,513,3509,143,216,479,415,64,458,373,85,537,371,166,617,400,217,21.108,10.231,6.156
16065,Idaho,Madison County,38241,33620,23.5,16168,4042,2015,4930,166,273,5784,5316,468,5671,5165,506,2574,2224,350,1909,1628,281,37.463,8.905,5.538
16079,Idaho,Shoshone County,12490,39835,47.2,9109,803,326,3933,130,176,447,327,120,407,288,119,539,411,128,492,357,135,12.394,7.78,4.475
16049,Idaho,Idaho County,16275,40299,49.5,11941,1596,686,5124,177,475,391,285,106,430,320,110,517,403,114,654,433,221,19.111,12.724,9.27
16081,Idaho,Teton County,10776,55986,36.4,7054,2116,884,2742,65,234,482,406,76,290,226,64,638,562,76,682,599,83,42.529,10.904,8.534
16077,Idaho,Power County,7667,47602,34.8,4663,502,235,1784,54,96,420,278,142,311,129,182,307,242,65,433,250,183,15.805,8.408,5.381
16087,Idaho,Washington County,9996,37521,46.1,7074,784,377,2910,110,267,271,107,164,252,176,76,461,295,166,412,342,70,16.412,12.955,9.175
17067,Illinois,Hancock County,18264,51460,46,13130,1809,784,6068,80,179,624,549,75,600,556,44,858,793,65,801,769,32,19.749,4.268,2.95
17119,Illinois,Madison County,266153,56536,40,184528,30349,17990,75734,2056,3972,11614,10162,1452,11979,11137,842,16052,13840,2212,15453,14257,1196,26.196,7.959,5.245
17063,Illinois,Grundy County,50333,71598,37.5,33231,4949,2554,13695,443,713,1999,1819,180,2048,1782,266,2827,2589,238,2869,2637,232,22.578,8.441,5.206
17091,Illinois,Kankakee County,110801,56542,37.7,72871,9028,5425,27511,1024,1808,5297,4289,1008,5978,5238,740,5858,4749,1109,5828,5243,585,19.834,10.294,6.572
17131,Illinois,Mercer County,15794,55649,44.8,11246,1480,625,5126,143,247,578,523,55,477,422,55,669,601,68,711,674,37,18.718,7.608,4.819
17043,Illinois,DuPage County,931826,84442,39.1,632912,183959,119948,249800,10744,20867,41350,36097,5253,39539,35586,3953,53929,45833,8096,52595,46637,5958,48.017,12.655,8.353
17167,Illinois,Sangamon County,198134,58687,40.1,136402,29200,17399,58052,1346,2817,8225,7030,1195,8615,7953,662,10636,9073,1563,11610,10921,689,34.163,7.171,4.853
17003,Illinois,Alexander County,6776,31014,42.3,4625,374,123,1714,56,119,233,186,47,308,285,23,264,210,54,267,262,5,10.746,10.21,6.943
17129,Illinois,Menard County,12416,62368,42.3,8740,1516,634,3974,72,148,410,379,31,365,361,4,560,527,33,627,610,17,24.6,5.536,3.724
17157,Illinois,Randolph County,32829,49717,41.5,23893,2189,950,9126,202,285,1278,1136,142,959,906,53,1560,1385,175,1459,1301,158,13.138,5.336,3.123
17137,Illinois,Morgan County,34442,49353,41.2,23818,3430,1630,9578,213,578,1697,1554,143,1693,1643,50,1540,1311,229,1845,1670,175,21.244,8.259,6.035
17031,Illinois,Cook County,5238541,59426,36.4,3578782,796547,534409,1112383,51902,116316,249847,193039,56808,256591,217461,39130,376789,293962,82827,382143,327473,54670,37.19,15.122,10.456
17141,Illinois,Ogle County,51619,57655,41.9,35732,4669,2354,15594,489,950,2066,1705,361,1899,1676,223,2477,2160,317,2482,2297,185,19.655,9.228,6.092
17115,Illinois,Macon County,107587,49052,41,73678,10855,5900,30998,525,1477,4834,4130,704,4923,4621,302,5162,4348,814,5645,5200,445,22.741,6.458,4.765
17177,Illinois,Stephenson County,45839,46427,44.7,32234,3909,2123,13537,375,654,1745,1335,410,1847,1562,285,2070,1640,430,1963,1837,126,18.713,7.601,4.831
17191,Illinois,Wayne County,16569,46405,43.4,11631,1129,402,5451,119,177,610,509,101,562,518,44,827,686,141,807,693,114,13.163,5.43,3.247
17193,Illinois,White County,14186,46279,43.8,10088,1008,564,4752,20,130,503,372,131,548,468,80,710,640,70,693,687,6,15.583,3.157,2.736
17203,Illinois,Woodford County,38942,69507,39.9,25942,5802,2260,12020,309,555,1613,1529,84,1480,1407,73,1773,1523,250,1891,1814,77,31.077,7.188,4.617
17055,Illinois,Franklin County,39302,39454,42.3,27627,2724,1476,11767,271,509,1502,1094,408,1429,1180,249,1928,1589,339,2109,1716,393,15.203,6.629,4.326
17071,Illinois,Henderson County,6927,47428,49.2,5114,588,138,2397,46,53,226,161,65,235,187,48,281,249,32,306,266,40,14.196,4.13,2.211
17109,Illinois,McDonough County,31597,42911,31.3,18357,3133,2860,7659,146,232,3620,3298,322,3429,3101,328,1702,1350,352,1602,1501,101,32.647,4.935,3.029
17111,Illinois,McHenry County,308043,82230,39.9,205777,45497,22875,88011,4106,6868,13140,11486,1654,11953,10631,1322,15304,13179,2125,15049,13518,1531,33.226,12.469,7.804
17113,Illinois,McLean County,173231,64573,32.7,104486,31061,15629,42861,1114,1641,13963,12770,1193,14997,14229,768,10168,9228,940,10324,9761,563,44.685,6.428,3.829
17139,Illinois,Moultrie County,14711,53979,39.9,9931,1233,567,4441,105,186,494,378,116,494,435,59,814,647,167,811,708,103,18.125,6.553,4.188
17145,Illinois,Perry County,21467,45864,41.8,15244,1381,532,6137,139,306,788,679,109,799,717,82,856,744,112,844,822,22,12.549,7.251,4.986
17149,Illinois,Pike County,15930,41387,42.4,11115,1350,440,5137,123,204,577,482,95,599,545,54,760,552,208,758,688,70,16.104,6.366,3.971
17151,Illinois,Pope County,4360,41139,52.2,3403,307,139,1399,4,33,205,200,5,103,103,0,61,59,2,152,152,0,13.106,2.645,2.359
17161,Illinois,Rock Island County,146205,51426,40,100347,14918,7880,41434,798,1812,6129,5307,822,6522,5936,586,8286,6924,1362,7990,7187,803,22.719,6.299,4.373
17163,Illinois,St. Clair County,264433,51103,38,177839,28056,19221,67109,1980,3904,11508,8930,2578,11199,9789,1410,13957,11330,2627,15883,14463,1420,26.584,8.768,5.817
17173,Illinois,Shelby County,21906,49807,44.6,15576,1768,719,7415,171,312,837,670,167,794,745,49,1048,863,185,1022,922,100,15.967,6.514,4.208
17185,Illinois,Wabash County,11568,49716,42.8,8038,1055,452,3711,84,92,448,364,84,470,434,36,657,582,75,611,580,31,18.748,4.743,2.479
17019,Illinois,Champaign County,207946,49586,29.7,119960,26436,26266,44405,1141,2075,24024,22255,1769,21489,20297,1192,13616,11706,1910,12870,11872,998,43.933,7.242,4.673
17013,Illinois,Calhoun County,4897,53641,46.5,3524,278,206,1546,58,86,213,210,3,147,131,16,180,164,16,186,181,5,13.734,9.314,5.563
17035,Illinois,Cumberland County,10899,50680,41.9,7630,773,375,3389,73,150,344,270,74,348,308,40,619,511,108,575,523,52,15.046,6.58,4.426
17053,Illinois,Ford County,13470,50851,43.2,9393,1330,469,4035,58,175,500,394,106,450,398,52,664,530,134,608,574,34,19.153,5.774,4.337
17085,Illinois,Jo Daviess County,22046,55532,49.4,16312,2453,1380,7677,216,456,673,532,141,655,626,29,911,754,157,875,758,117,23.498,8.753,5.94
17089,Illinois,Kane County,529402,74862,36.6,340594,71465,38722,128974,5392,10345,23740,19477,4263,22347,19196,3151,29242,22224,7018,28801,23962,4839,32.351,12.202,8.021
17093,Illinois,Kendall County,122933,89860,34.5,77030,17324,9493,32645,1308,2853,4915,4338,577,4347,4000,347,7033,6394,639,7891,7326,565,34.814,12.746,8.739
17101,Illinois,Lawrence County,16457,44504,41.2,11891,1026,348,4459,101,137,556,470,86,490,398,92,643,571,72,743,654,89,11.555,5.338,3.072
17009,Illinois,Brown County,6791,56289,38.7,5047,489,175,1628,17,66,216,204,12,167,156,11,276,262,14,265,245,20,13.156,5.098,4.054
17121,Illinois,Marion County,38305,44679,41.8,26532,2633,1406,11893,331,405,1535,1199,336,1533,1426,107,2085,1707,378,1957,1760,197,15.223,6.189,3.405
17123,Illinois,Marshall County,11925,55173,46.3,8583,1144,351,4071,66,165,464,400,64,406,375,31,524,455,69,532,488,44,17.418,5.674,4.053
17125,Illinois,Mason County,13904,44695,45.5,10022,1046,497,4662,54,211,479,411,68,488,444,44,644,562,82,579,554,25,15.396,5.684,4.526
17075,Illinois,Iroquois County,28457,48857,44.3,20091,1867,1001,8997,198,663,1088,868,220,1047,923,124,1267,975,292,1315,1218,97,14.275,9.57,7.369
17021,Illinois,Christian County,33562,50668,42.7,23940,2650,1269,10449,168,322,1261,1093,168,1211,1079,132,1492,1320,172,1584,1498,86,16.37,4.689,3.082
17025,Illinois,Clay County,13393,47427,44,9445,1037,371,4447,43,269,581,522,59,524,492,32,634,532,102,625,570,55,14.907,7.016,6.049
17059,Illinois,Gallatin County,5226,42450,44.8,3751,358,123,1744,53,11,180,142,38,183,159,24,260,240,20,247,246,1,12.823,3.67,0.631
17077,Illinois,Jackson County,59115,36008,31.1,35285,6092,6687,12706,334,584,6723,6218,505,5911,5362,549,3893,3139,754,3474,2987,487,36.217,7.225,4.596
17133,Illinois,Monroe County,33739,74410,42.3,23611,4572,2653,10852,317,478,1162,1041,121,1057,997,60,1680,1532,148,1669,1624,45,30.6,7.326,4.405
17143,Illinois,Peoria County,186145,53063,37,124320,23520,14022,48422,1118,2427,8366,7003,1363,9012,8262,750,11605,9679,1926,11637,10656,981,30.198,7.321,5.012
17181,Illinois,Union County,17267,46716,43.5,12359,1751,1001,5365,134,219,588,440,148,603,525,78,1006,852,154,858,751,107,22.267,6.58,4.082
17201,Illinois,Winnebago County,287512,51110,39.6,194834,27530,16167,75723,2514,4588,12154,9842,2312,12214,11059,1155,15341,12794,2547,16275,14817,1458,22.428,9.379,6.059
17147,Illinois,Piatt County,16433,67360,43,11539,2214,1073,5452,118,150,532,481,51,513,491,22,849,806,43,811,741,70,28.486,4.916,2.751
17153,Illinois,Pulaski County,5691,34655,43.3,4063,289,166,1656,44,46,209,184,25,156,128,28,303,274,29,335,313,22,11.199,5.435,2.778
17169,Illinois,Schuyler County,7181,47321,46.6,5409,650,317,2277,54,35,276,180,96,196,127,69,316,189,127,299,266,33,17.878,3.909,1.537
17175,Illinois,Stark County,5551,52284,45,3919,512,224,1872,38,61,183,154,29,186,169,17,262,210,52,225,204,21,18.78,5.288,3.259
17045,Illinois,Edgar County,17603,47873,44.5,12639,1495,734,5678,132,188,690,598,92,639,494,145,850,749,101,865,774,91,17.636,5.636,3.311
17005,Illinois,Bond County,17034,54393,40.4,11904,1492,804,4803,120,148,705,658,47,914,881,33,754,561,193,785,729,56,19.288,5.58,3.081
17007,Illinois,Boone County,53638,62701,38.3,34783,4580,2981,14820,866,1084,2152,1881,271,2257,2037,220,2713,2226,487,2574,2239,335,21.738,13.158,7.314
17011,Illinois,Bureau County,33619,54271,43.7,23618,2971,1484,10518,237,442,1327,1124,203,1305,1132,173,1566,1320,246,1589,1486,103,18.863,6.456,4.202
17015,Illinois,Carroll County,14704,50555,47.4,10746,1208,661,5048,148,171,539,454,85,542,437,105,658,546,112,658,597,61,17.393,6.319,3.387
17029,Illinois,Coles County,52540,41907,34.3,32910,4849,3720,12996,273,412,4664,4013,651,4808,4386,422,3085,2351,734,3240,2873,367,26.038,5.271,3.17
17033,Illinois,Crawford County,19214,47468,42.5,13948,1630,721,5979,66,225,694,582,112,674,564,110,939,789,150,916,797,119,16.855,4.867,3.763
17083,Illinois,Jersey County,22215,56320,42.5,15267,1970,1042,7179,102,477,976,791,185,1086,994,92,1132,1025,107,1054,895,159,19.729,8.065,6.644
17155,Illinois,Putnam County,5771,64741,47.5,4235,410,221,1945,71,95,257,240,17,174,155,19,234,201,33,285,280,5,14.9,8.535,4.884
17039,Illinois,De Witt County,16176,55411,42.8,11463,1717,609,5220,107,148,615,558,57,552,534,18,772,634,138,797,739,58,20.291,4.885,2.835
17051,Illinois,Fayette County,21980,44541,41.4,15451,1316,527,6184,134,260,883,678,205,881,758,123,925,784,141,1020,875,145,11.928,6.371,4.204
17103,Illinois,Lee County,34670,58319,42.7,24995,2727,1728,9905,216,354,1390,1135,255,1147,1049,98,1479,1383,96,1540,1390,150,17.824,5.755,3.574
17107,Illinois,Logan County,29488,58271,40.6,20844,2965,1152,8016,165,217,1326,1150,176,1237,1110,127,1485,1272,213,1119,1085,34,19.751,4.765,2.707
17117,Illinois,Macoupin County,45960,53890,43.1,32422,4017,1994,14310,260,428,1809,1585,224,1816,1616,200,2268,1803,465,2306,2183,123,18.54,4.808,2.991
17159,Illinois,Richland County,15953,46454,42.3,11155,1735,659,4596,72,58,659,607,52,584,531,53,808,721,87,779,740,39,21.461,2.829,1.262
17165,Illinois,Saline County,24430,40722,42,17140,1865,952,7208,97,342,923,669,254,892,746,146,1368,1182,186,1380,1287,93,16.435,6.09,4.745
17189,Illinois,Washington County,14260,54520,43,10164,1381,672,4631,116,197,505,415,90,487,399,88,770,706,64,731,699,32,20.199,6.759,4.254
17135,Illinois,Montgomery County,29173,47807,42.4,20954,1858,1163,8767,281,350,855,731,124,998,880,118,885,802,83,1456,1376,80,14.417,7.197,3.992
17195,Illinois,Whiteside County,56823,51969,42.9,39619,4647,2525,17671,481,642,2116,1710,406,2102,1905,197,2870,2275,595,2688,2394,294,18.102,6.355,3.633
17001,Illinois,Adams County,66787,48454,41.5,46161,6821,3962,19373,319,761,2453,2141,312,2827,2621,206,3787,3355,432,3592,3315,277,23.36,5.575,3.928
17027,Illinois,Clinton County,37640,64543,40.4,26627,4136,1749,11440,255,429,1344,1301,43,1467,1248,219,2110,1801,309,1964,1831,133,22.102,5.979,3.75
17037,Illinois,DeKalb County,104473,58343,30.7,61324,11634,7116,21139,761,1133,9619,8671,948,9721,8784,937,6395,5376,1019,6275,5782,493,30.575,8.96,5.36
17047,Illinois,Edwards County,6570,49632,43.6,4568,400,171,2347,30,52,254,213,41,238,201,37,298,238,60,292,282,10,12.5,3.494,2.216
17079,Illinois,Jasper County,9608,56523,43,6700,786,379,3036,62,67,343,320,23,335,277,58,451,382,69,445,429,16,17.388,4.249,2.207
17081,Illinois,Jefferson County,38358,46109,40.9,26760,2578,1740,11179,297,581,1524,1339,185,1410,1242,168,1693,1372,321,1914,1805,109,16.136,7.854,5.197
17183,Illinois,Vermilion County,79207,44930,40.2,53825,5532,2339,21928,494,693,2916,2220,696,2966,2650,316,3844,3059,785,4293,3907,386,14.623,5.413,3.16
17197,Illinois,Will County,687727,80782,37.3,444963,95679,53654,184080,8381,15133,30896,26299,4597,29220,26739,2481,34515,28532,5983,35727,32049,3678,33.561,12.774,8.221
17199,Illinois,Williamson County,67477,48600,40.9,47536,6288,4401,19396,511,815,2629,2004,625,2615,2245,370,3724,3047,677,3679,3377,302,22.486,6.836,4.202
17023,Illinois,Clark County,15924,52068,43,11047,1272,622,5061,121,158,530,453,77,609,527,82,854,735,119,745,654,91,17.145,5.513,3.122
17041,Illinois,Douglas County,19830,52261,37.9,13199,1849,645,5495,84,192,727,506,221,742,538,204,1070,835,235,1060,827,233,18.895,5.023,3.494
17049,Illinois,Effingham County,34164,54655,39.1,23094,3741,1477,10443,206,341,1498,1328,170,1346,1272,74,2071,1806,265,1877,1734,143,22.595,5.238,3.265
17057,Illinois,Fulton County,35733,48599,42.5,25732,3121,1428,10906,334,352,1187,1014,173,1170,1077,93,1644,1282,362,1585,1412,173,17.678,6.29,3.228
17061,Illinois,Greene County,13311,44502,42.7,9378,827,298,3976,62,145,473,389,84,505,400,105,720,615,105,610,533,77,11.996,5.206,3.647
17065,Illinois,Hamilton County,8259,47293,43.6,5818,592,391,2689,17,83,313,282,31,241,241,0,389,356,33,429,392,37,16.896,3.719,3.087
17069,Illinois,Hardin County,4161,39524,46.8,3129,280,67,1165,32,1,135,77,58,129,97,32,175,95,80,145,136,9,11.09,2.833,0.086
17073,Illinois,Henry County,49649,55755,42.7,34567,5307,2333,15635,359,551,1985,1795,190,1642,1404,238,2305,2008,297,2407,2354,53,22.102,5.82,3.524
17087,Illinois,Johnson County,12899,45743,42.5,9404,1022,500,3655,99,175,346,252,94,310,264,46,396,335,61,530,493,37,16.185,7.497,4.788
17095,Illinois,Knox County,51374,41972,42.2,35756,4094,2303,13862,272,423,2455,1936,519,2696,2324,372,2418,1947,471,2139,1920,219,17.891,5.014,3.052
17097,Illinois,Lake County,704476,82613,38,455774,118151,83502,179525,7331,14945,32105,26883,5222,29300,25023,4277,33056,26496,6560,33783,29228,4555,44.244,12.408,8.325
17105,Illinois,Livingston County,36812,54339,41.6,25661,2482,1387,10432,252,616,1292,1110,182,1399,1237,162,1771,1488,283,1800,1574,226,15.077,8.321,5.905
17127,Illinois,Massac County,14594,42168,43.8,10348,937,319,4471,118,284,575,510,65,442,398,44,606,512,94,732,647,85,12.138,8.991,6.352
17171,Illinois,Scott County,5109,48542,43.7,3605,356,146,1597,24,35,190,153,37,187,185,2,204,145,59,228,201,27,13.925,3.694,2.192
17179,Illinois,Tazewell County,134695,60874,40.8,93706,17038,7330,41725,859,1337,5107,4663,444,4986,4543,443,7243,6309,934,7327,6970,357,26.005,5.263,3.204
17017,Illinois,Cass County,12880,50156,40.2,8729,832,341,3786,67,110,437,333,104,487,411,76,776,652,124,688,624,64,13.438,4.675,2.905
17187,Illinois,Warren County,17429,47278,39.1,11404,1959,816,5084,94,117,1029,984,45,1023,993,30,747,631,116,853,813,40,24.334,4.15,2.301
17099,Illinois,LaSalle County,111151,54693,41.8,77586,9067,4729,32306,1047,1759,4626,4026,600,4142,3709,433,5868,4843,1025,5735,5122,613,17.782,8.686,5.445
18105,Indiana,Monroe County,144436,45689,28.8,81878,19422,18076,29793,989,1362,18998,16954,2044,18167,16427,1740,9329,7815,1514,8575,7680,895,45.797,7.891,4.572
18045,Indiana,Fountain County,16620,46669,43,11545,1074,583,5173,135,264,670,487,183,626,577,49,817,588,229,683,609,74,14.353,7.713,5.103
18039,Indiana,Elkhart County,202924,52449,35.4,128152,15620,8353,49240,1062,1996,9349,7090,2259,8704,6614,2090,10972,7581,3391,11467,8256,3211,18.707,6.21,4.054
18149,Indiana,Starke County,22966,45526,41.7,15788,1193,599,7050,248,409,961,732,229,847,688,159,1042,848,194,1180,1059,121,11.35,9.319,5.801
18025,Indiana,Crawford County,10598,40067,43.7,7473,486,293,3334,132,128,328,277,51,399,317,82,520,470,50,440,396,44,10.424,7.798,3.839
18017,Indiana,Cass County,38248,45558,40.5,25935,2334,1131,10956,192,470,1664,1055,609,1269,887,382,1833,1353,480,2085,1561,524,13.36,6.042,4.29
18055,Indiana,Greene County,32431,49648,42.8,22716,2102,1192,10086,279,487,1375,1097,278,1147,1059,88,1476,1053,423,1573,1338,235,14.501,7.595,4.828
18097,Indiana,Marion County,939964,44869,34.3,615756,118164,64860,198434,7037,13137,46336,35499,10837,50155,41645,8510,64798,48320,16478,70551,57578,12973,29.723,10.167,6.62
18177,Indiana,Wayne County,66972,41813,41.1,45907,4901,3436,17791,467,1079,3097,2383,714,2910,2313,597,3258,2233,1025,3458,2612,846,18.161,8.69,6.065
18053,Indiana,Grant County,67615,42046,39.9,44546,4637,2978,17858,455,887,3786,3109,677,4737,4272,465,3047,1994,1053,3216,2496,720,17.095,7.515,4.967
18021,Indiana,Clay County,26375,50924,40.9,18220,2031,998,8193,241,238,1006,720,286,1087,895,192,1350,1091,259,1447,1255,192,16.625,5.846,2.905
18063,Indiana,Hendricks County,158170,74245,37.6,104392,24513,12320,44977,1111,2175,6219,5226,993,5499,4955,544,8319,7312,1007,9170,8338,832,35.283,7.306,4.836
18037,Indiana,Dubois County,42379,57307,40.2,28458,4394,1697,12719,163,294,1639,1387,252,1777,1440,337,2063,1783,280,2007,1728,279,21.403,3.593,2.312
18047,Indiana,Franklin County,22835,55588,42.3,15509,2001,1051,7099,182,300,903,762,141,803,713,90,1019,820,199,1074,912,162,19.679,6.79,4.226
18059,Indiana,Hancock County,72776,70973,40.2,49508,10029,4879,21358,556,892,3044,2820,224,2740,2311,429,3367,2868,499,3710,3171,539,30.112,6.78,4.176
18071,Indiana,Jackson County,43779,49080,38.2,29579,3112,1581,12027,336,589,1667,1394,273,1716,1484,232,2335,1823,512,2386,1890,496,15.866,7.691,4.897
18067,Indiana,Howard County,82457,47958,41.5,56980,7467,4131,23580,709,1042,3277,2490,787,3350,2999,351,4175,3379,796,4431,3657,774,20.355,7.426,4.419
18115,Indiana,Ohio County,5911,58359,46.8,4388,384,237,1959,58,63,181,163,18,195,151,44,306,273,33,264,230,34,14.152,6.177,3.216
18119,Indiana,Owen County,20957,48315,44.6,14921,1024,867,6762,191,306,732,508,224,665,506,159,1021,685,336,955,737,218,12.673,7.35,4.525
18121,Indiana,Parke County,17062,44643,42.2,12051,1056,461,4721,107,269,578,385,193,542,419,123,741,585,156,742,549,193,12.588,7.964,5.698
18135,Indiana,Randolph County,25203,44985,42.1,17404,1368,1012,7964,166,403,885,622,263,809,681,128,1165,875,290,1276,1036,240,13.675,7.145,5.06
18183,Indiana,Whitley County,33481,57041,41,23080,2880,1612,10711,249,388,1286,984,302,1209,1058,151,1830,1495,335,1627,1467,160,19.463,5.947,3.622
18007,Indiana,Benton County,8685,49183,40.9,5841,744,236,2509,35,87,397,280,117,306,278,28,408,319,89,402,320,82,16.778,4.862,3.468
18013,Indiana,Brown County,15007,59292,49.3,11254,1421,1444,5022,234,272,463,331,132,449,379,70,639,478,161,606,422,184,25.458,10.076,5.416
18023,Indiana,Clinton County,32455,51659,38.2,21277,2297,1040,8552,203,342,1193,1014,179,1243,975,268,1787,1538,249,1792,1445,347,15.684,6.373,3.999
18133,Indiana,Putnam County,37543,55295,37.8,24756,2210,1611,9693,419,532,2225,1839,386,2281,2135,146,1476,1174,302,1580,1231,349,15.435,9.811,5.488
18161,Indiana,Union County,7225,45531,43.3,4973,582,292,2076,98,121,312,242,70,226,163,63,290,193,97,323,256,67,17.575,10.549,5.829
18175,Indiana,Washington County,27807,46861,41.2,19059,1425,878,8034,309,332,1061,919,142,1041,872,169,1319,1063,256,1276,1153,123,12.084,7.979,4.132
18027,Indiana,Daviess County,32777,48355,34.6,20237,1875,991,8478,162,400,1473,1016,457,1471,1098,373,1811,1141,670,1650,1070,580,14.162,6.629,4.718
18029,Indiana,Dearborn County,49564,62905,42.7,33999,4855,2524,14770,671,698,1953,1635,318,1739,1607,132,2309,1783,526,2315,1968,347,21.704,9.269,4.726
18065,Indiana,Henry County,48649,46131,42.2,34455,3791,1903,13227,366,701,1871,1588,283,1571,1439,132,2377,1849,528,2331,1826,505,16.526,8.067,5.3
18083,Indiana,Knox County,37763,44837,38.1,24759,2532,1443,9596,230,335,2758,2309,449,1853,1654,199,2065,1744,321,1893,1471,422,16.055,5.888,3.491
18093,Indiana,Lawrence County,45669,49985,42.6,32030,3195,1953,14523,370,737,1756,1543,213,1613,1394,219,2225,1768,457,2393,2009,384,16.072,7.622,5.075
18095,Indiana,Madison County,129641,45432,40.2,89800,10584,5175,35694,887,1949,5215,3999,1216,5456,4519,937,6699,4851,1848,6894,5449,1445,17.549,7.945,5.46
18123,Indiana,Perry County,19229,49689,41.9,13635,1002,948,5765,104,257,767,641,126,603,494,109,801,747,54,893,780,113,14.301,6.262,4.458
18125,Indiana,Pike County,12471,50196,43.9,8795,739,413,4219,48,95,406,301,105,451,391,60,603,535,68,543,489,54,13.098,3.389,2.252
18131,Indiana,Pulaski County,12761,47633,41.8,8884,727,318,4044,131,272,478,318,160,371,267,104,580,485,95,649,581,68,11.763,9.965,6.726
18129,Indiana,Posey County,25599,60992,42.5,17829,2388,1301,8422,197,221,1033,892,141,884,765,119,1300,1119,181,1340,1233,107,20.691,4.963,2.624
18151,Indiana,Steuben County,34459,52749,42.7,23551,3003,1779,10743,279,491,1959,1618,341,1303,1081,222,1644,1351,293,1556,1304,252,20.305,7.167,4.57
18171,Indiana,Warren County,8269,58950,44.6,5870,767,370,2850,62,47,248,222,26,284,276,8,379,328,51,386,308,78,19.37,3.825,1.649
18165,Indiana,Vermillion County,15644,45440,43.2,10949,985,437,4902,140,171,507,407,100,623,492,131,790,629,161,721,629,92,12.987,6.344,3.488
18179,Indiana,Wells County,27832,53038,39.8,18701,2368,1107,8689,261,326,1091,925,166,952,815,137,1355,1235,120,1461,1352,109,18.582,6.756,3.752
18043,Indiana,Floyd County,76481,59451,39.9,52041,9263,5497,20993,622,918,3570,3052,518,3460,3072,388,3648,3037,611,4147,3613,534,28.362,7.336,4.373
18003,Indiana,Allen County,367747,51091,35.7,237509,42678,22525,97441,2179,4007,17049,13481,3568,17396,14786,2610,21167,16565,4602,22384,18345,4039,27.453,6.348,4.112
18031,Indiana,Decatur County,26480,52270,38.8,17757,2281,1220,7182,229,238,1141,985,156,1028,877,151,1432,1188,244,1395,1163,232,19.716,6.502,3.314
18035,Indiana,Delaware County,115938,41208,35.4,71195,9852,7196,29732,761,1278,10522,8947,1575,11084,9762,1322,5728,4112,1616,5549,4567,982,23.946,6.858,4.298
18103,Indiana,Miami County,36035,46666,39.9,24872,1944,1193,9459,321,390,1315,911,404,1508,1342,166,1947,1385,562,1624,1391,233,12.613,7.517,4.123
18077,Indiana,Jefferson County,32293,50722,40.6,22097,2324,1527,9093,345,283,1481,1219,262,1601,1380,221,1517,1249,268,1371,1200,171,17.428,6.906,3.112
18079,Indiana,Jennings County,27840,48362,39.6,18680,1375,624,7987,326,472,1339,963,376,1265,968,297,1298,1015,283,1179,953,226,10.701,9.991,5.91
18081,Indiana,Johnson County,149359,65272,37.3,98960,20575,9976,38974,1273,1933,6254,5484,770,6615,6026,589,8269,6736,1533,8738,7361,1377,30.872,8.226,4.96
18109,Indiana,Morgan County,69533,60317,41.5,47577,5093,2548,19763,772,862,2652,2236,416,2717,2298,419,3279,2753,526,3566,3004,562,16.06,8.268,4.362
18051,Indiana,Gibson County,33596,51149,40.5,22827,2568,1261,10312,222,325,1316,1109,207,1373,1173,200,1769,1439,330,1643,1479,164,16.774,5.304,3.152
18111,Indiana,Newton County,14056,52193,42.5,9859,744,337,4149,109,228,451,298,153,568,501,67,787,645,142,699,526,173,10.965,8.122,5.495
18117,Indiana,Orange County,19623,42803,41.3,13461,960,630,5900,173,313,798,622,176,692,550,142,963,805,158,920,766,154,11.812,8.237,5.305
18141,Indiana,St. Joseph County,268613,48121,36.5,174455,30387,19237,68361,1868,3216,14233,11870,2363,15283,13204,2079,15024,11705,3319,15357,12837,2520,28.445,7.437,4.704
18085,Indiana,Kosciusko County,78720,57190,38,52041,7526,4056,22632,663,867,3462,2998,464,3627,3042,585,4691,3507,1184,4343,3529,814,22.256,6.76,3.831
18099,Indiana,Marshall County,46752,51869,39.8,30831,3823,2271,13018,299,601,1939,1588,351,1968,1468,500,2241,1686,555,2180,1727,453,19.766,6.914,4.617
18155,Indiana,Switzerland County,10617,43468,40,7159,451,172,3005,86,279,296,246,50,381,297,84,521,357,164,535,393,142,8.702,12.146,9.285
18163,Indiana,Vanderburgh County,181831,44815,37.9,123257,20697,11574,47989,1336,2654,9219,7461,1758,10016,8813,1203,11052,8957,2095,11648,10095,1553,26.182,8.314,5.53
18009,Indiana,Blackford County,12214,40622,43.7,8610,506,454,3973,126,135,503,408,95,417,360,57,558,404,154,553,387,166,11.15,6.569,3.398
18015,Indiana,Carroll County,19994,56188,42.3,13909,1528,730,6391,184,240,704,562,142,634,545,89,885,709,176,942,733,209,16.234,6.634,3.755
18143,Indiana,Scott County,23722,49243,40.7,16245,1279,821,6668,243,340,1032,823,209,966,776,190,1148,848,300,1274,1049,225,12.927,8.743,5.099
18061,Indiana,Harrison County,39450,53897,42.7,27639,2893,1689,12140,382,585,1393,1215,178,1426,1247,179,2054,1635,419,1943,1561,382,16.578,7.965,4.819
18069,Indiana,Huntington County,36520,50063,40.3,24887,2771,1742,11159,310,389,1656,1346,310,1674,1497,177,2051,1635,416,1933,1673,260,18.134,6.264,3.486
18091,Indiana,LaPorte County,110839,49921,40.2,77203,8931,4827,30717,761,1686,3949,3356,593,3978,3156,822,5149,3797,1352,5686,4620,1066,17.821,7.966,5.489
18169,Indiana,Wabash County,31848,49052,42,21810,2388,1694,9567,117,514,1620,1357,263,1426,1263,163,1474,1135,339,1477,1260,217,18.716,6.596,5.373
18181,Indiana,White County,24279,51404,42,16729,1781,1003,7623,228,260,856,653,203,858,742,116,1083,868,215,1187,1008,179,16.642,6.402,3.411
18073,Indiana,Jasper County,33448,56574,39,22258,2132,1183,9337,322,311,1515,1334,181,1511,1354,157,1732,1457,275,1594,1310,284,14.894,6.779,3.331
18075,Indiana,Jay County,21107,42878,39.8,13871,916,534,6070,134,297,927,615,312,922,762,160,1012,784,228,932,717,215,10.453,7.1,4.893
18101,Indiana,Martin County,10219,49372,42,7106,457,325,3422,75,148,344,326,18,352,273,79,529,427,102,464,440,24,11.005,6.517,4.325
18127,Indiana,Porter County,167391,65979,39.4,113686,19582,11658,47702,1298,2997,7690,6297,1393,7286,6370,916,9132,7505,1627,9119,7847,1272,27.479,9.004,6.283
18145,Indiana,Shelby County,44339,57216,41.3,30587,3670,1823,12925,354,612,1662,1404,258,1662,1400,262,2213,1781,432,2310,1808,502,17.959,7.474,4.735
18137,Indiana,Ripley County,28372,53698,40.6,19184,2350,1151,8549,211,474,1299,1171,128,982,887,95,1313,1039,274,1412,1219,193,18.25,8.013,5.545
18147,Indiana,Spencer County,20610,55280,43.2,14377,1479,802,6644,150,255,765,711,54,643,547,96,940,800,140,949,853,96,15.866,6.096,3.838
18153,Indiana,Sullivan County,20900,45031,41.4,14952,1271,595,5528,47,237,857,629,228,660,520,140,1088,799,289,1042,730,312,12.48,5.137,4.287
18159,Indiana,Tipton County,15290,53931,44.5,10848,1515,793,5071,185,116,610,536,74,439,337,102,781,583,198,642,568,74,21.276,5.936,2.288
18157,Indiana,Tippecanoe County,186081,50486,28.1,102561,21124,16701,37260,699,1622,24097,21408,2689,19007,16737,2270,11936,9506,2430,11049,9432,1617,36.88,6.229,4.353
18167,Indiana,Vigo County,107723,42030,36.1,69061,10051,6206,24908,679,1068,7973,6678,1295,7845,6763,1082,5864,4416,1448,5200,4440,760,23.54,7.014,4.288
18173,Indiana,Warrick County,61581,66080,40.5,41987,7662,4610,19118,482,843,2045,1818,227,2037,1831,206,3211,2612,599,3072,2721,351,29.228,6.931,4.409
18057,Indiana,Hamilton County,309687,90582,36.6,199803,73578,41296,89184,2088,4381,10743,9320,1423,10042,8830,1212,16188,14189,1999,18173,16434,1739,57.494,7.254,4.912
18033,Indiana,DeKalb County,42524,51374,39.1,28431,3503,1564,12489,441,466,1692,1336,356,1709,1512,197,2305,1838,467,2265,1662,603,17.822,7.262,3.731
18087,Indiana,LaGrange County,38720,58336,31.5,22347,1556,655,9898,288,619,1837,1012,825,1761,846,915,2033,957,1076,1974,918,1056,9.894,9.163,6.254
18005,Indiana,Bartholomew County,81024,57331,38.1,54857,10155,6986,22345,726,960,3586,2616,970,3299,2646,653,5342,4607,735,4437,3919,518,31.247,7.545,4.296
18139,Indiana,Rush County,16765,47955,41.6,11539,1122,588,4842,89,239,589,521,68,606,516,90,813,520,293,797,613,184,14.819,6.774,4.936
18011,Indiana,Boone County,63013,75591,38.4,41421,11596,7966,18367,467,917,2266,1909,357,2159,1985,174,3021,2592,429,3284,2907,377,47.227,7.535,4.993
18049,Indiana,Fulton County,20296,47108,41.9,14015,1166,631,6141,127,242,794,718,76,818,762,56,992,767,225,894,781,113,12.822,6.009,3.941
18089,Indiana,Lake County,488694,52559,38.6,326499,47030,22939,128486,4689,8412,21941,16787,5154,21445,17857,3588,25510,18992,6518,27596,22617,4979,21.43,10.196,6.547
18107,Indiana,Montgomery County,38288,53075,40.5,25785,3270,1403,10742,291,488,1978,1569,409,1560,1330,230,1912,1521,391,1788,1404,384,18.123,7.252,4.543
18113,Indiana,Noble County,47421,52393,38.5,31331,3051,1322,13543,393,554,1911,1590,321,1905,1430,475,2570,2119,451,2319,2034,285,13.957,6.993,4.091
18001,Indiana,Adams County,35018,48290,33.3,21052,2116,1013,9491,238,491,1560,1096,464,1381,1027,354,1861,1284,577,1798,1275,523,14.863,7.681,5.173
18019,Indiana,Clark County,114893,52834,38.8,79085,10961,4825,31157,917,1618,4311,3349,962,5004,4202,802,7001,5685,1316,6842,5970,872,19.961,8.136,5.193
18041,Indiana,Fayette County,23426,41476,42.4,16358,1228,584,6473,162,293,1016,706,310,930,737,193,1081,857,224,1041,786,255,11.077,7.029,4.526
19055,Iowa,Delaware County,17326,60534,43.4,11803,1354,646,5695,92,420,638,579,59,614,581,33,813,687,126,738,699,39,16.945,8.99,7.375
19101,Iowa,Jefferson County,17945,44516,40.9,12591,2434,1773,4623,105,165,1239,995,244,796,711,85,1217,1089,128,845,757,88,33.413,5.84,3.569
19185,Iowa,Wayne County,6405,42434,43.3,4383,416,188,2122,27,123,212,175,37,220,169,51,285,259,26,316,247,69,13.781,7.069,5.796
19005,Iowa,Allamakee County,13940,47895,45,9760,1208,504,4617,31,259,615,488,127,438,332,106,589,511,78,605,520,85,17.541,6.281,5.61
19113,Iowa,Linn County,220008,62702,37.4,146925,33089,14341,66089,1420,2720,10131,9081,1050,10387,9697,690,13577,12283,1294,13476,12704,772,32.282,6.264,4.116
19163,Iowa,Scott County,171493,57681,38.1,115570,23088,13789,46422,1092,2565,7298,6447,851,7261,6670,591,10092,8362,1730,10489,9405,1084,31.909,7.878,5.525
19049,Iowa,Dallas County,80864,82719,35.1,52638,18159,7670,23560,448,768,2511,2229,282,2823,2689,134,5483,5040,443,5404,5102,302,49.069,5.161,3.26
19141,Iowa,O'Brien County,13944,56314,43.3,9678,1435,485,4334,77,55,504,458,46,498,480,18,718,649,69,608,556,52,19.839,3.046,1.269
19011,Iowa,Benton County,25646,64061,42.1,17550,2764,1098,8322,279,275,964,865,99,830,764,66,1189,1105,84,1139,1110,29,22.006,6.657,3.304
19023,Iowa,Butler County,14822,53937,43.7,10437,1286,478,4947,109,209,545,479,66,448,417,31,672,601,71,706,641,65,16.901,6.428,4.225
19061,Iowa,Dubuque County,96571,59150,38.6,64135,12576,6679,27476,551,1002,5105,4599,506,4707,4436,271,5516,4962,554,5266,4764,502,30.023,5.652,3.647
19071,Iowa,Fremont County,6985,54430,46,4971,682,354,2251,13,117,213,144,69,214,200,14,305,276,29,288,267,21,20.841,5.775,5.198
19079,Iowa,Hamilton County,15201,55836,42.6,10642,1784,712,4560,48,194,445,418,27,579,421,158,786,666,120,768,715,53,23.454,5.307,4.254
19151,Iowa,Pocahontas County,6972,45969,47.2,4978,648,136,2402,10,44,252,200,52,215,207,8,318,277,41,298,269,29,15.749,2.248,1.832
19173,Iowa,Taylor County,6214,46825,43.3,4357,446,177,2050,66,61,213,195,18,229,185,44,297,249,48,263,242,21,14.299,6.195,2.976
19175,Iowa,Union County,12497,47597,40.1,8516,956,412,3751,72,92,570,479,91,466,375,91,593,446,147,664,513,151,16.064,4.372,2.453
19177,Iowa,Van Buren County,7308,47197,44,5074,508,194,2415,29,64,232,160,72,241,187,54,313,268,45,331,263,68,13.835,3.851,2.65
19195,Iowa,Worth County,7502,50880,44.4,5244,586,213,2564,67,39,302,243,59,248,239,9,331,296,35,353,310,43,15.236,4.134,1.521
19159,Iowa,Ringgold County,4986,50642,45,3499,521,181,1545,43,82,172,167,5,131,126,5,231,200,31,258,235,23,20.063,8.091,5.307
19003,Iowa,Adams County,3785,49745,47.7,2739,357,118,1287,19,30,126,112,14,148,128,20,184,183,1,168,155,13,17.342,3.807,2.331
19001,Iowa,Adair County,7192,49477,45.7,5167,598,211,2460,10,72,261,192,69,204,191,13,338,279,59,348,335,13,15.657,3.333,2.927
19009,Iowa,Audubon County,5711,48750,48.3,4147,414,154,2102,57,34,196,170,26,222,183,39,250,189,61,211,179,32,13.697,4.329,1.618
19037,Iowa,Chickasaw County,12140,50688,44.2,8351,964,334,4140,107,133,441,406,35,389,353,36,540,487,53,536,513,23,15.543,5.797,3.213
19039,Iowa,Clarke County,9267,49718,40.7,6364,822,271,2644,40,142,434,398,36,370,370,0,398,357,41,491,444,47,17.175,6.884,5.371
19051,Iowa,Davis County,8834,52390,37.5,5580,666,326,2644,112,88,316,174,142,291,172,119,406,297,109,404,252,152,17.778,7.564,3.328
19059,Iowa,Dickinson County,17000,59889,48.7,12620,2572,1147,6100,150,315,609,481,128,517,459,58,829,751,78,788,754,34,29.469,7.623,5.164
19093,Iowa,Ida County,6965,51978,44.7,4872,794,167,2278,16,62,236,206,30,205,187,18,322,311,11,326,319,7,19.725,3.424,2.722
19103,Iowa,Johnson County,144425,59965,29.9,84554,23817,20709,34032,780,1296,14355,13139,1216,14786,13912,874,10346,8913,1433,9809,8883,926,52.66,6.1,3.808
19107,Iowa,Keokuk County,10223,48399,44,7173,955,346,3443,79,159,389,337,52,353,323,30,520,467,53,430,409,21,18.137,6.913,4.618
19135,Iowa,Monroe County,7912,50179,42.2,5376,677,174,2552,20,106,354,311,43,295,284,11,385,301,84,344,285,59,15.83,4.937,4.154
19171,Iowa,Tama County,17236,56110,43.2,11727,1415,519,5167,124,218,612,502,110,598,503,95,801,731,70,764,690,74,16.492,6.619,4.219
19179,Iowa,Wapello County,35321,43329,39.5,24091,2858,1572,10413,213,436,1791,1569,222,1503,1371,132,1942,1552,390,1958,1765,193,18.389,6.233,4.187
19167,Iowa,Sioux County,34692,66022,33.3,20534,4023,1614,9688,151,261,2229,2080,149,2198,2134,64,1849,1564,285,1692,1473,219,27.452,4.253,2.694
19069,Iowa,Franklin County,10326,48172,42.4,7203,825,336,3074,112,233,419,353,66,303,293,10,494,452,42,517,485,32,16.118,11.223,7.58
19025,Iowa,Calhoun County,9814,46302,45.1,6990,885,444,3259,61,105,302,298,4,330,298,32,407,361,46,434,384,50,19.013,5.094,3.222
19027,Iowa,Carroll County,20428,54563,41.7,13863,2361,757,6517,76,208,636,563,73,785,726,59,980,930,50,951,919,32,22.492,4.358,3.192
19031,Iowa,Cedar County,18368,62555,41.9,12942,2220,676,5980,143,218,636,588,48,636,633,3,861,802,59,889,828,61,22.377,6.037,3.645
19033,Iowa,Cerro Gordo County,43134,50569,44.5,30737,4887,1924,13234,302,424,1786,1446,340,1709,1312,397,2258,1784,474,2123,1958,165,22.159,5.486,3.204
19067,Iowa,Floyd County,15904,48607,44.6,11046,1787,526,5016,64,155,657,547,110,611,571,40,664,613,51,644,563,81,20.94,4.366,3.09
19073,Iowa,Greene County,9046,52529,45.7,6363,926,383,2902,66,96,338,288,50,323,266,57,389,321,68,377,352,25,20.572,5.582,3.308
19083,Iowa,Hardin County,17239,52207,44.4,12067,1774,726,5483,64,165,734,678,56,650,608,42,842,739,103,831,784,47,20.718,4.177,3.009
19115,Iowa,Louisa County,11238,54393,41,7694,834,314,3383,37,155,474,444,30,374,337,37,578,553,25,565,524,41,14.921,5.675,4.582
19117,Iowa,Lucas County,8600,47325,44.8,5959,778,229,2852,47,162,357,331,26,299,261,38,319,279,40,334,329,5,16.899,7.328,5.68
19119,Iowa,Lyon County,11745,62012,38,7609,1217,433,3807,138,70,468,440,28,379,345,34,585,509,76,533,509,24,21.685,5.464,1.839
19189,Iowa,Winnebago County,10545,50072,42.5,7305,1168,355,3406,37,104,439,421,18,386,351,35,505,484,21,507,487,20,20.849,4.14,3.053
19147,Iowa,Palo Alto County,9110,50470,42.3,6275,1232,372,2869,68,85,377,366,11,388,328,60,457,435,22,402,370,32,25.562,5.333,2.963
19165,Iowa,Shelby County,11772,55638,46.9,8304,1321,441,3996,140,134,388,331,57,375,335,40,466,370,96,452,428,24,21.219,6.857,3.353
19007,Iowa,Appanoose County,12547,40377,45.1,8948,1156,472,4111,92,291,408,312,96,427,407,20,624,533,91,636,552,84,18.194,9.316,7.079
19087,Iowa,Henry County,19865,52275,40.4,13600,1998,709,5531,115,216,778,667,111,749,729,20,934,825,109,945,889,56,19.904,5.984,3.905
19095,Iowa,Iowa County,16231,58077,41.8,11229,1544,721,5237,123,243,558,474,84,604,496,108,791,693,98,760,688,72,20.171,6.989,4.64
19099,Iowa,Jasper County,36789,56363,42.6,25859,3561,1127,10716,266,369,1295,1126,169,1321,1173,148,1808,1598,210,1678,1618,60,18.129,5.926,3.443
19145,Iowa,Page County,15393,46708,44.4,11118,1662,630,4719,125,79,582,481,101,544,483,61,647,559,88,610,578,32,20.615,4.323,1.674
19191,Iowa,Winneshiek County,20575,60788,41,13462,2366,1514,6345,154,241,1442,1383,59,1497,1440,57,926,822,104,832,754,78,28.822,6.225,3.798
19157,Iowa,Poweshiek County,18428,51456,40.7,11984,1648,1071,5287,137,216,1236,1091,145,1302,1158,144,806,738,68,839,770,69,22.689,6.677,4.085
19155,Iowa,Pottawattamie County,93287,56291,39.6,62841,9163,4134,25201,640,1096,4271,3560,711,3738,3421,317,4860,4085,775,5174,4624,550,21.16,6.889,4.349
19127,Iowa,Marshall County,40476,52752,38.5,26767,3721,1512,10902,229,327,1868,1491,377,1514,1300,214,2070,1710,360,2111,1734,377,19.55,5.1,2.999
19043,Iowa,Clayton County,17711,51114,46.5,12608,1471,511,5768,162,223,584,480,104,585,508,77,783,696,87,760,666,94,15.72,6.675,3.866
19015,Iowa,Boone County,26381,57906,41.4,18304,3124,1314,8303,141,468,972,913,59,1048,1027,21,1434,1250,184,1357,1262,95,24.246,7.335,5.637
19017,Iowa,Bremer County,24741,65440,39.2,16263,3321,1401,7690,181,233,1397,1325,72,1391,1356,35,1180,1106,74,1178,1128,50,29.035,5.384,3.03
19021,Iowa,Buena Vista County,20369,52784,35.1,12786,1838,733,5005,61,205,1193,893,300,1247,1083,164,1207,1007,200,1031,861,170,20.108,5.315,4.096
19089,Iowa,Howard County,9321,51422,41.8,6363,627,303,3105,117,136,343,337,6,338,275,63,482,383,99,445,385,60,14.616,8.148,4.38
19063,Iowa,Emmet County,9661,47419,42.5,6512,967,373,3200,62,114,564,447,117,421,340,81,386,258,128,427,364,63,20.577,5.5,3.562
19077,Iowa,Guthrie County,10664,56306,45.7,7521,1125,461,3525,65,155,403,378,25,342,318,24,410,328,82,421,365,56,21.088,6.241,4.397
19081,Iowa,Hancock County,10971,57840,44.5,7778,1183,424,3757,80,150,351,341,10,331,313,18,555,488,67,487,440,47,20.661,6.122,3.993
19091,Iowa,Humboldt County,9586,48847,43,6692,1032,317,3121,41,99,331,327,4,361,354,7,462,415,47,485,442,43,20.158,4.486,3.172
19121,Iowa,Madison County,15720,60077,40.8,10634,1894,602,4875,174,248,438,398,40,514,512,2,660,536,124,766,687,79,23.472,8.656,5.087
19125,Iowa,Marion County,33127,57917,39.5,21619,3920,1714,9313,144,428,1730,1640,90,1563,1497,66,1605,1469,136,1592,1536,56,26.06,6.142,4.596
19183,Iowa,Washington County,22095,59157,40.8,14961,2179,978,6291,170,185,856,713,143,812,696,116,1120,933,187,1088,949,139,21.102,5.643,2.941
19197,Iowa,Wright County,12864,48935,44.3,8954,1182,389,4054,92,172,510,422,88,421,379,42,581,487,94,582,494,88,17.545,6.512,4.243
19029,Iowa,Cass County,13327,45637,44.6,9405,1343,504,4198,39,230,465,447,18,426,381,45,591,505,86,645,607,38,19.638,6.408,5.479
19035,Iowa,Cherokee County,11577,53998,46.3,8317,1199,420,3981,53,79,447,398,49,347,274,73,532,450,82,454,428,26,19.466,3.316,1.984
19047,Iowa,Crawford County,17131,51091,37.6,11143,1117,334,4613,56,162,868,705,163,667,605,62,1357,1121,236,686,546,140,13.022,4.726,3.512
19057,Iowa,Des Moines County,39876,47524,42.5,27689,3884,1601,12095,203,404,1593,1264,329,1530,1382,148,1838,1446,392,2050,1869,181,19.809,5.019,3.34
19065,Iowa,Fayette County,20139,48412,43.7,13887,1897,857,6300,139,176,916,794,122,785,713,72,994,868,126,900,822,78,19.831,5,2.794
19085,Iowa,Harrison County,14196,57558,44,9912,1311,453,4669,105,179,527,461,66,491,431,60,708,617,91,642,594,48,17.797,6.083,3.834
19109,Iowa,Kossuth County,15166,54868,45.8,10689,1705,402,5280,105,173,568,546,22,577,542,35,735,647,88,642,596,46,19.712,5.265,3.277
19129,Iowa,Mills County,14933,67949,42.1,10287,1629,714,4407,125,186,464,434,30,430,421,9,686,619,67,717,672,45,22.776,7.057,4.221
19133,Iowa,Monona County,8865,41598,46.7,6487,705,345,2833,52,130,286,230,56,301,282,19,522,458,64,316,294,22,16.186,6.424,4.589
19139,Iowa,Muscatine County,42923,56398,38.1,28378,4129,1860,11892,273,586,1746,1574,172,1881,1743,138,2479,2141,338,2181,1948,233,21.104,7.223,4.928
19143,Iowa,Osceola County,6149,53604,44,4283,595,163,1980,45,75,235,201,34,160,159,1,316,287,29,255,211,44,17.698,6.061,3.788
19153,Iowa,Polk County,467235,63530,35.2,308247,75457,33397,121656,3368,6524,20936,18175,2761,22148,20020,2128,32483,28468,4015,32145,29087,3058,35.314,8.131,5.363
19187,Iowa,Webster County,36945,42148,39.6,24701,3608,1440,10195,242,555,2063,1773,290,1613,1450,163,1823,1587,236,1765,1558,207,20.436,7.818,5.444
19169,Iowa,Story County,95888,52671,25.9,49223,13567,11316,19135,389,593,15765,14860,905,12487,11765,722,5750,5249,501,5075,4740,335,50.552,5.132,3.099
19193,Iowa,Woodbury County,102397,51350,35.6,65199,10188,4423,25920,430,1049,5045,4012,1033,4768,4224,544,5997,5003,994,5840,5070,770,22.41,5.706,4.047
19013,Iowa,Black Hawk County,132960,50916,34.9,83456,15068,7901,34857,674,1674,9969,8829,1140,10494,9715,779,7460,6547,913,7485,6791,694,27.522,6.736,4.802
19075,Iowa,Grundy County,12354,65170,42.4,8600,1712,549,4143,99,89,444,421,23,396,380,16,601,563,38,605,571,34,26.291,4.538,2.148
19097,Iowa,Jackson County,19409,51806,44.6,13640,1678,854,6502,123,211,702,634,68,664,641,23,912,791,121,795,700,95,18.563,5.137,3.245
19105,Iowa,Jones County,20468,58391,43.6,14549,1708,801,6266,153,264,576,489,87,707,624,83,853,754,99,950,855,95,17.245,6.655,4.213
19111,Iowa,Lee County,34785,48266,43.3,24467,2740,1094,10655,212,392,1315,1087,228,1271,1142,129,1811,1490,321,1686,1523,163,15.67,5.669,3.679
19131,Iowa,Mitchell County,10663,53675,43.7,7264,934,310,3602,85,114,388,315,73,366,298,68,467,329,138,462,382,80,17.126,5.525,3.165
19137,Iowa,Montgomery County,10239,43674,44.5,7143,867,281,3131,90,106,380,269,111,342,331,11,376,339,37,428,411,17,16.072,6.26,3.385
19181,Iowa,Warren County,48630,71514,38.2,31753,6961,2686,14340,412,654,2031,1858,173,2322,2195,127,2532,2355,177,2377,2242,135,30.381,7.434,4.561
19161,Iowa,Sac County,9936,53254,45.9,7035,1026,364,3400,88,70,307,242,65,305,253,52,470,437,33,386,376,10,19.758,4.647,2.059
19123,Iowa,Mahaska County,22301,50568,39.7,14982,2546,1024,6313,166,295,1061,960,101,856,799,57,1188,1025,163,1157,1051,106,23.829,7.302,4.673
19149,Iowa,Plymouth County,25027,61316,40.5,16716,2696,769,7972,154,302,889,738,151,875,808,67,1157,1037,120,1115,1025,90,20.729,5.72,3.788
19019,Iowa,Buchanan County,21101,59348,38.7,13993,2019,637,6529,139,325,651,566,85,734,684,50,1193,1000,193,1038,912,126,18.981,7.107,4.978
19041,Iowa,Clay County,16387,48978,42.2,11457,1921,562,5027,85,239,623,543,80,522,479,43,847,679,168,786,722,64,21.672,6.445,4.754
19045,Iowa,Clinton County,47587,50295,42.2,32898,4346,1965,14759,409,542,1798,1642,156,1862,1660,202,2336,1937,399,2278,2111,167,19.184,6.444,3.672
19053,Iowa,Decatur County,8105,41042,36.5,4908,638,418,2106,51,127,750,659,91,588,474,114,350,251,99,308,205,103,21.516,8.452,6.03
20183,Kansas,Smith County,3693,45357,51.6,2738,394,156,1289,13,41,113,105,8,98,69,29,124,106,18,154,111,43,20.088,4.189,3.181
20067,Kansas,Grant County,7716,57474,32.6,4613,538,209,2066,10,102,378,297,81,330,167,163,481,281,200,416,299,117,16.193,5.421,4.937
20085,Kansas,Jackson County,13322,53592,41.4,8932,1183,592,3959,93,166,453,387,66,427,407,20,633,545,88,617,530,87,19.872,6.542,4.193
20095,Kansas,Kingman County,7576,57593,45.5,5340,908,334,2446,51,65,242,188,54,258,194,64,356,298,58,324,279,45,23.258,4.742,2.657
20109,Kansas,Logan County,2790,49926,40.4,1919,262,104,877,3,29,108,100,8,89,86,3,170,149,21,125,121,4,19.072,3.649,3.307
20021,Kansas,Cherokee County,20501,41101,41.4,14012,1713,945,5975,120,281,668,475,193,629,516,113,1064,836,228,1005,798,207,18.969,6.711,4.703
20131,Kansas,Nemaha County,10095,53368,40.4,6658,1122,458,3069,16,101,396,337,59,329,250,79,504,458,46,476,414,62,23.731,3.812,3.291
20149,Kansas,Pottawatomie County,23188,64410,35.2,14674,3310,1612,6668,210,265,739,641,98,895,714,181,1302,1160,142,1390,1221,169,33.542,7.124,3.974
20209,Kansas,Wyandotte County,163227,42783,33.7,102821,11616,5576,34112,1286,2000,7434,4678,2756,7543,5082,2461,10946,6692,4254,10985,7615,3370,16.72,9.633,5.863
20015,Kansas,Butler County,66260,62324,38.1,43322,8573,4103,17906,483,898,2707,2319,388,2395,1987,408,2982,2534,448,3371,2847,524,29.26,7.712,5.015
20027,Kansas,Clay County,8203,55434,43,5730,927,441,2707,65,112,295,247,48,235,216,19,339,261,78,346,302,44,23.874,6.539,4.137
20105,Kansas,Lincoln County,3121,48693,46.6,2206,287,153,1031,6,34,80,76,4,73,45,28,115,108,7,125,104,21,19.946,3.88,3.298
20169,Kansas,Saline County,55334,49728,37.9,37069,6167,3114,14845,418,796,2604,2143,461,2424,1872,552,2943,2452,491,2998,2550,448,25.037,8.178,5.362
20191,Kansas,Sumner County,23336,52695,40.7,15641,2444,819,6790,128,215,928,749,179,836,679,157,1198,904,294,1085,907,178,20.862,5.052,3.166
20195,Kansas,Trego County,2899,55197,49.4,2121,347,148,1095,41,14,102,96,6,121,101,20,111,89,22,88,82,6,23.338,5.023,1.279
20197,Kansas,Wabaunsee County,6918,58947,43.4,4741,711,366,2308,73,62,248,206,42,209,191,18,295,252,43,325,295,30,22.717,5.849,2.686
20205,Kansas,Wilson County,8858,44468,44,6150,649,307,2866,83,134,308,230,78,309,229,80,417,316,101,378,302,76,15.545,7.572,4.676
20207,Kansas,Woodson County,3178,36493,48.6,2348,241,80,1242,23,23,83,79,4,73,56,17,152,126,26,175,127,48,13.671,3.704,1.852
20123,Kansas,Mitchell County,6230,44591,43.7,4226,698,321,1971,32,86,357,298,59,192,190,2,267,234,33,275,245,30,24.113,5.987,4.363
20135,Kansas,Ness County,3001,48412,47.2,2184,323,93,1091,20,33,90,88,2,60,51,9,174,142,32,174,142,32,19.048,4.858,3.025
20141,Kansas,Osborne County,3684,42173,47.4,2642,429,159,1231,0,66,128,108,20,133,128,5,197,140,57,170,129,41,22.256,5.361,5.361
20005,Kansas,Atchison County,16466,46640,35.9,10127,1324,777,4183,114,241,1178,981,197,1141,1085,56,664,523,141,840,614,226,20.747,8.487,5.761
20011,Kansas,Bourbon County,14757,39379,39.3,9565,1191,640,3963,55,114,653,551,102,547,481,66,764,491,273,679,499,180,19.143,4.264,2.877
20055,Kansas,Finney County,37097,51703,30.6,21627,2518,1223,7855,225,499,2104,1640,464,1874,1588,286,2339,1733,606,2084,1601,483,17.298,9.217,6.353
20075,Kansas,Hamilton County,2621,48160,33.4,1615,225,63,593,3,31,158,110,48,36,19,17,157,53,104,183,100,83,17.833,5.734,5.228
20097,Kansas,Kiowa County,2524,48226,40.8,1642,309,145,682,20,36,139,112,27,144,125,19,111,104,7,102,85,17,27.649,8.211,5.279
20103,Kansas,Leavenworth County,79359,70022,37.3,53657,9459,7160,18532,363,919,2811,2491,320,2748,2577,171,3517,3085,432,3997,3538,459,30.973,6.918,4.959
20177,Kansas,Shawnee County,178392,54667,38.9,120131,23162,13321,46411,1229,1528,7492,5725,1767,7421,6289,1132,9758,7838,1920,10295,8874,1421,30.369,5.94,3.292
20181,Kansas,Sherman County,5999,52030,38.5,4064,565,175,1782,51,104,390,368,22,297,292,5,187,163,24,261,191,70,18.209,8.698,5.836
20187,Kansas,Stanton County,2107,42222,39.3,1368,260,49,623,3,24,14,14,0,73,58,15,90,90,0,57,46,11,22.588,4.334,3.852
20193,Kansas,Thomas County,7847,52465,36.3,5030,946,389,2425,30,112,387,383,4,542,514,28,513,391,122,478,443,35,26.541,5.856,4.619
20119,Kansas,Meade County,4295,54167,37.7,2755,394,176,1203,31,34,182,143,39,182,138,44,217,158,59,181,120,61,20.69,5.403,2.826
20125,Kansas,Montgomery County,33463,43977,40.3,22524,2891,1314,9559,160,427,1545,1079,466,1277,951,326,1772,1322,450,1671,1284,387,18.669,6.141,4.467
20127,Kansas,Morris County,5605,50338,47.9,4097,485,258,1809,46,81,161,143,18,128,117,11,264,175,89,232,188,44,18.135,7.02,4.478
20151,Kansas,Pratt County,9670,53415,39.2,6265,1119,538,2664,56,59,579,413,166,462,376,86,444,423,21,438,357,81,26.449,4.317,2.215
20153,Kansas,Rawlins County,2520,50893,50.3,1873,365,135,869,8,25,86,73,13,77,68,9,123,114,9,111,105,6,26.695,3.797,2.877
20163,Kansas,Rooks County,5148,48352,43.6,3608,602,324,1714,33,52,150,129,21,190,179,11,234,188,46,244,203,41,25.665,4.959,3.034
20003,Kansas,Anderson County,7840,40986,42.2,5361,574,424,2284,41,169,256,136,120,242,241,1,376,316,60,320,269,51,18.616,9.194,7.399
20025,Kansas,Clark County,2089,46094,44.2,1433,382,93,632,6,39,98,98,0,55,32,23,89,72,17,92,85,7,33.147,7.12,6.171
20053,Kansas,Ellsworth County,6331,48550,43.7,4612,661,276,1921,40,77,151,136,15,188,132,56,252,223,29,273,262,11,20.317,6.091,4.008
20061,Kansas,Geary County,35796,46096,26.4,19185,2879,1219,5044,162,393,1337,997,340,2065,1781,284,1927,1608,319,2892,2565,327,21.36,11.003,7.791
20077,Kansas,Harper County,5746,48059,42.5,3989,466,233,1723,13,43,193,110,83,167,125,42,287,228,59,273,214,59,17.523,3.25,2.496
20057,Kansas,Ford County,34658,49890,31.1,20419,2480,1259,7093,102,341,1865,1419,446,1704,1329,375,2324,1608,716,1950,1312,638,18.311,6.246,4.808
20167,Kansas,Russell County,6987,48427,48.7,5134,667,574,2414,78,76,248,201,47,71,60,11,323,302,21,472,422,50,24.172,6.379,3.148
20111,Kansas,Lyon County,33302,42992,32.9,19909,3498,1893,7795,224,272,2777,2151,626,2988,2451,537,1735,1322,413,1773,1443,330,27.078,6.363,3.489
20117,Kansas,Marshall County,9859,50420,44,6921,844,442,3177,90,119,315,279,36,263,220,43,495,395,100,490,421,69,18.581,6.579,3.746
20145,Kansas,Pawnee County,6776,46224,44.5,5038,579,340,1825,52,101,197,141,56,221,197,24,216,201,15,265,188,77,18.241,8.384,5.534
20001,Kansas,Allen County,12752,43031,41.6,8625,1086,573,3834,58,115,506,455,51,516,442,74,592,509,83,580,545,35,19.235,4.512,2.999
20023,Kansas,Cheyenne County,2677,47167,47.8,1893,386,102,997,15,30,77,65,12,59,37,22,119,95,24,136,117,19,25.779,4.514,3.009
20033,Kansas,Comanche County,1741,51563,49.5,1228,167,60,593,0,3,43,40,3,75,69,6,34,29,5,58,32,26,18.485,0.506,0.506
20035,Kansas,Cowley County,35732,46624,38.2,23253,3215,1508,9020,163,340,1858,1325,533,1781,1458,323,1703,1274,429,1826,1506,320,20.311,5.576,3.769
20049,Kansas,Elk County,2581,39405,50.8,1933,164,141,944,29,24,40,22,18,53,45,8,103,58,45,96,74,22,15.779,5.614,2.542
20063,Kansas,Gove County,2632,50817,48.5,1934,365,82,922,13,28,64,52,12,92,70,22,126,88,38,136,117,19,23.113,4.447,3.037
20059,Kansas,Franklin County,25599,53167,40,16982,2302,1150,7137,221,311,1144,982,162,1051,943,108,1273,1013,260,1307,1058,249,20.327,7.454,4.358
20079,Kansas,Harvey County,34683,55687,39.2,22810,4122,2711,9445,155,213,1654,1135,519,1303,1124,179,1690,1343,347,1995,1555,440,29.956,3.896,2.255
20083,Kansas,Hodgeman County,1875,55345,46.8,1338,235,92,568,6,30,63,49,14,48,48,0,85,64,21,83,51,32,24.439,6.338,5.282
20089,Kansas,Jewell County,2963,43125,51.9,2216,255,98,1113,13,24,88,77,11,81,76,5,121,97,24,104,89,15,15.93,3.324,2.156
20093,Kansas,Kearny County,3931,51439,34.8,2449,210,118,970,42,63,197,176,21,143,125,18,202,173,29,194,172,22,13.393,10.825,6.495
20159,Kansas,Rice County,9868,48333,38.5,6354,961,470,2856,32,152,643,524,119,467,384,83,535,419,116,446,326,120,22.521,6.443,5.322
20185,Kansas,Stafford County,4251,47121,42.7,2941,494,171,1511,18,28,154,135,19,136,103,33,211,140,71,213,164,49,22.611,3.044,1.853
20113,Kansas,McPherson County,28792,56946,40.8,19413,3881,1677,8662,206,240,1418,1211,207,1418,1236,182,1495,1312,183,1314,1096,218,28.63,5.149,2.771
20139,Kansas,Osage County,15894,54186,43.4,10988,1548,725,4938,156,234,554,456,98,603,470,133,690,536,154,708,614,94,20.686,7.898,4.739
20071,Kansas,Greeley County,1210,47045,48.7,831,200,52,320,3,9,29,29,0,59,49,10,72,46,26,46,40,6,30.325,3.75,2.813
20031,Kansas,Coffey County,8328,58662,44,5869,910,316,2734,82,57,320,254,66,255,200,55,402,316,86,408,326,82,20.889,5.084,2.085
20037,Kansas,Crawford County,39099,38017,32.5,23369,4221,2535,8903,196,358,3850,3308,542,3040,2539,501,2001,1507,494,2206,1841,365,28.91,6.223,4.021
20051,Kansas,Ellis County,28877,49562,32,17221,4297,1830,7214,101,238,2840,2543,297,2651,2198,453,1804,1523,281,1503,1286,217,35.579,4.699,3.299
20073,Kansas,Greenwood County,6227,41648,48.6,4521,584,271,2046,14,109,209,161,48,168,130,38,272,195,77,215,177,38,18.912,6.012,5.327
20099,Kansas,Labette County,20553,45706,41,14004,1614,855,5727,164,202,749,549,200,725,572,153,1100,926,174,966,733,233,17.631,6.391,3.527
20107,Kansas,Linn County,9602,46576,43.6,6786,708,251,3385,91,204,262,189,73,332,267,65,403,313,90,389,315,74,14.132,8.715,6.027
20173,Kansas,Sedgwick County,510484,52841,35,328321,66165,34525,124608,3571,6432,24699,19337,5362,24386,20023,4363,30871,23622,7249,32024,26581,5443,30.668,8.028,5.162
20175,Kansas,Seward County,22948,47535,29.5,13265,1185,422,4986,215,309,1294,813,481,1089,756,333,1769,1171,598,1346,932,414,12.115,10.509,6.197
20157,Kansas,Republic County,4705,43489,50.9,3523,490,330,1747,26,61,171,163,8,118,103,15,205,182,23,184,182,2,23.276,4.98,3.492
20065,Kansas,Graham County,2561,43427,50.8,1934,418,112,1001,27,70,54,47,7,60,46,14,143,97,46,105,100,5,27.404,9.69,6.993
20091,Kansas,Johnson County,578797,81121,37.3,388234,132207,79876,154575,3976,7032,22596,19566,3030,22451,20247,2204,35951,31439,4512,36406,32502,3904,54.628,7.121,4.549
20045,Kansas,Douglas County,117806,54370,29.2,67159,17727,15825,23201,684,1212,13735,12371,1364,13168,11584,1584,8428,6612,1816,7512,6770,742,49.959,8.172,5.224
20179,Kansas,Sheridan County,2497,56607,44.7,1808,324,120,889,8,22,40,37,3,75,75,0,143,109,34,103,61,42,24.558,3.375,2.475
20121,Kansas,Miami County,32976,63501,41.7,22327,3876,1900,9962,278,563,1085,912,173,1033,814,219,1449,1198,251,1433,1202,231,25.87,8.442,5.651
20069,Kansas,Gray County,6004,61220,35.9,3743,594,191,1626,9,33,223,202,21,245,186,59,284,226,58,322,283,39,20.972,2.583,2.03
20199,Kansas,Wallace County,1591,60000,40.6,1087,229,58,464,10,17,59,59,0,53,49,4,86,55,31,79,71,8,26.403,5.819,3.664
20017,Kansas,Chase County,2665,42772,45,1855,335,130,859,22,33,92,86,6,82,64,18,93,74,19,111,95,16,25.067,6.403,3.842
20189,Kansas,Stevens County,5741,57500,35.1,3555,405,171,1421,0,80,239,159,80,123,74,49,290,249,41,271,178,93,16.203,5.63,5.63
20201,Kansas,Washington County,5572,47992,46.2,3911,562,184,1879,17,41,217,185,32,160,151,9,227,195,32,226,210,16,19.074,3.087,2.182
20203,Kansas,Wichita County,2157,55109,41.2,1461,224,73,627,18,3,53,38,15,65,54,11,120,89,31,163,131,32,20.329,3.349,0.478
20019,Kansas,Chautauqua County,3425,39531,48.7,2490,309,105,1114,12,35,135,86,49,72,69,3,158,135,23,164,143,21,16.627,4.219,3.142
20129,Kansas,Morton County,2931,43813,39.5,1852,158,85,765,32,27,191,171,20,98,76,22,146,111,35,100,95,5,13.121,7.712,3.529
20137,Kansas,Norton County,5527,50673,43.5,3972,528,110,1468,12,27,302,276,26,89,60,29,166,146,20,176,140,36,16.062,2.657,1.839
20155,Kansas,Reno County,63360,47897,40.1,43237,5873,2783,17186,411,509,2742,2302,440,2433,1933,500,3209,2592,617,3166,2699,467,20.02,5.353,2.962
20009,Kansas,Barton County,27067,46070,39.6,18253,2161,925,7752,161,178,1090,791,299,1047,758,289,1580,1136,444,1465,1092,373,16.907,4.373,2.296
20029,Kansas,Cloud County,9191,44199,41.8,6194,772,541,2858,35,100,479,343,136,411,343,68,467,397,70,502,435,67,21.198,4.724,3.499
20043,Kansas,Doniphan County,7790,50300,39.4,5113,645,224,2206,18,63,447,311,136,403,346,57,347,305,42,405,340,65,16.996,3.672,2.856
20047,Kansas,Edwards County,2946,50229,44.8,2062,286,101,996,6,11,83,69,14,94,61,33,100,81,19,140,107,33,18.768,1.707,1.104
20081,Kansas,Haskell County,4081,53780,36.1,2503,295,145,1009,16,48,198,99,99,143,55,88,184,157,27,211,146,65,17.579,6.343,4.757
20101,Kansas,Lane County,1702,51765,41.5,1163,206,72,649,16,17,67,66,1,53,41,12,83,54,29,69,67,2,23.904,5.085,2.619
20165,Kansas,Rush County,3119,43594,47.9,2294,347,184,1114,18,23,76,59,17,101,80,21,162,126,36,131,101,30,23.147,3.68,2.065
20171,Kansas,Scott County,4981,62198,40.5,3302,630,250,1568,0,86,275,259,16,168,168,0,248,172,76,214,196,18,26.651,5.485,5.485
20115,Kansas,Marion County,12087,50212,45,8329,1356,634,3889,87,164,584,505,79,483,427,56,474,417,57,505,396,109,23.892,6.454,4.217
20133,Kansas,Neosho County,16209,44402,39.7,10777,1173,916,4554,98,231,712,576,136,651,581,70,782,535,247,799,533,266,19.384,7.224,5.072
20013,Kansas,Brown County,9736,46964,42.2,6564,878,512,2829,95,128,377,332,45,286,222,64,451,388,63,501,426,75,21.176,7.883,4.525
20143,Kansas,Ottawa County,5957,51797,42.4,4109,682,232,2023,34,79,228,188,40,139,122,17,255,197,58,231,191,40,22.244,5.586,3.905
20147,Kansas,Phillips County,5446,46806,44.3,3769,570,241,1819,19,22,151,124,27,210,196,14,270,253,17,218,205,13,21.518,2.254,1.209
20161,Kansas,Riley County,75696,48428,24.9,37648,9250,7886,11284,252,359,10574,9753,821,10059,9423,636,5040,4520,520,5181,4563,618,45.516,5.415,3.181
20007,Kansas,Barber County,4905,52075,43.4,3411,393,287,1366,12,50,149,127,22,148,140,8,314,218,96,239,161,78,19.936,4.539,3.66
20039,Kansas,Decatur County,2891,41230,51.3,2165,318,156,1032,15,70,90,81,9,93,74,19,149,96,53,91,71,20,21.894,8.236,6.783
20041,Kansas,Dickinson County,19162,49663,41.2,13182,1937,809,5672,168,200,645,455,190,634,542,92,1010,837,173,946,830,116,20.831,6.488,3.526
20087,Kansas,Jefferson County,18856,58935,44,13175,1887,906,6285,147,291,593,459,134,541,471,70,849,734,115,917,836,81,21.199,6.969,4.63
21097,Kentucky,Harrison County,18630,44620,41.8,12759,1225,735,4944,107,179,809,536,273,665,601,64,898,627,271,885,743,142,15.362,5.785,3.621
21031,Kentucky,Butler County,12735,39362,41.2,8971,610,442,3685,51,145,414,292,122,498,454,44,772,621,151,653,509,144,11.727,5.319,3.935
21223,Kentucky,Trimble County,8697,50998,41.9,6044,403,312,2766,73,122,300,267,33,275,255,20,394,347,47,454,377,77,11.83,7.05,4.411
21061,Kentucky,Edmonson County,12063,41114,43.1,8612,540,419,3929,59,270,578,502,76,493,417,76,630,592,38,609,522,87,11.136,8.374,6.872
21105,Kentucky,Hickman County,4625,38036,48.3,3297,152,154,1530,35,61,193,176,17,113,110,3,168,118,50,161,122,39,9.281,6.275,3.987
21023,Kentucky,Bracken County,8330,40458,40.7,5654,438,352,2482,77,145,295,265,30,320,287,33,444,388,56,401,379,22,13.972,8.944,5.842
21143,Kentucky,Lyon County,8268,50268,49.2,6547,519,398,2784,119,139,253,185,68,210,188,22,259,156,103,194,139,55,14.006,9.267,4.993
21179,Kentucky,Nelson County,45131,55182,38.9,30234,3352,1932,13579,328,515,2007,1840,167,1886,1637,249,2356,2019,337,2616,2326,290,17.477,6.208,3.793
21231,Kentucky,Wayne County,20692,33715,42,14446,856,789,5833,113,315,869,691,178,958,713,245,983,701,282,827,745,82,11.387,7.338,5.4
21135,Kentucky,Lewis County,13565,32054,42.1,9518,565,590,4113,89,214,491,394,97,518,481,37,675,499,176,661,584,77,12.135,7.367,5.203
21155,Kentucky,Marion County,19335,40005,39.7,13137,926,777,5440,92,324,743,673,70,670,594,76,822,583,239,952,795,157,12.963,7.647,5.956
21221,Kentucky,Trigg County,14286,47259,45.5,10227,1056,674,4942,77,239,425,379,46,392,331,61,539,329,210,593,387,206,16.916,6.394,4.836
21239,Kentucky,Woodford County,25817,60604,42.3,17839,3480,2366,7094,242,432,787,721,66,1093,892,201,1293,1014,279,1193,1098,95,32.771,9.501,6.09
21015,Kentucky,Boone County,127682,72731,37.1,83393,16762,9498,33885,906,1927,4982,4215,767,4766,4336,430,6971,5992,979,7383,6390,993,31.489,8.361,5.687
21131,Kentucky,Leslie County,10648,27861,41.9,7534,386,288,3342,46,234,429,308,121,406,307,99,550,453,97,525,429,96,8.946,8.378,7.002
21113,Kentucky,Jessamine County,51667,55450,37.4,33487,5790,4253,11512,396,501,2582,2196,386,2458,2324,134,2599,2235,364,3057,2791,266,29.991,7.792,4.352
21121,Kentucky,Knox County,31424,26061,39.7,21046,967,1130,7768,133,293,1543,1113,430,1362,1159,203,1565,1197,368,1729,1263,466,9.964,5.484,3.772
21127,Kentucky,Lawrence County,15844,32703,40.9,10958,715,555,4782,170,250,575,455,120,591,496,95,831,719,112,831,691,140,11.59,8.783,5.228
21133,Kentucky,Letcher County,23011,30293,41.8,16385,1035,874,7465,106,396,766,618,148,766,667,99,1252,1102,150,1321,1168,153,11.651,6.725,5.305
21139,Kentucky,Livingston County,9288,43472,45.8,6743,406,195,2982,142,142,241,222,19,327,292,35,432,377,55,415,359,56,8.913,9.524,4.762
21145,Kentucky,McCracken County,65285,42894,42.1,45970,6875,4263,18457,511,1260,2325,1969,356,2472,2180,292,3356,2646,710,3468,2887,581,24.229,9.595,6.827
21195,Kentucky,Pike County,61586,32972,41.9,43282,2963,2660,18853,602,1006,2713,2203,510,2482,2064,418,3049,2586,463,3204,2896,308,12.992,8.529,5.336
21211,Kentucky,Shelby County,45831,63171,38.8,31052,4447,3097,11348,393,512,1900,1439,461,1763,1455,308,2370,1825,545,2604,2152,452,24.295,7.975,4.512
21235,Kentucky,Whitley County,36027,34103,37,23150,2503,2103,8861,236,555,1896,1622,274,1810,1525,285,1832,1515,317,1969,1836,133,19.896,8.927,6.263
21005,Kentucky,Anderson County,22017,51681,40.5,15096,1974,1052,6580,118,432,875,751,124,770,680,90,1104,949,155,1193,1095,98,20.045,8.359,6.565
21027,Kentucky,Breckinridge County,19991,44057,43.3,13844,754,620,5831,156,269,809,594,215,656,556,100,869,674,195,845,716,129,9.925,7.289,4.613
21071,Kentucky,Floyd County,37447,31196,41.4,26169,1653,1640,10631,294,661,1648,1147,501,1584,1464,120,1846,1401,445,1858,1542,316,12.584,8.983,6.218
21073,Kentucky,Franklin County,49969,53539,40.7,34882,6189,3725,13131,313,566,2423,1967,456,2083,1601,482,2665,2055,610,2791,2471,320,28.422,6.694,4.31
21117,Kentucky,Kenton County,163987,58674,36.9,110904,20853,12033,41329,1414,1975,7340,6434,906,6650,6048,602,10444,8803,1641,10841,9451,1390,29.653,8.2,4.779
21147,Kentucky,McCreary County,17748,19264,39.2,12234,559,376,4483,129,514,792,604,188,593,509,84,863,582,281,820,772,48,7.643,14.343,11.466
21151,Kentucky,Madison County,88376,46674,34,53820,9966,6354,19486,600,864,6993,5989,1004,7558,6623,935,4561,3826,735,4518,4062,456,30.323,7.513,4.434
21153,Kentucky,Magoffin County,12783,29578,42,8805,424,469,3475,39,186,526,436,90,449,350,99,688,566,122,662,634,28,10.142,6.475,5.353
21169,Kentucky,Metcalfe County,9990,35594,43.1,6925,391,448,3005,112,123,346,295,51,347,317,30,546,475,71,533,452,81,12.116,7.82,4.093
21189,Kentucky,Owsley County,4497,22736,41.8,3095,206,280,1252,12,139,237,215,22,233,193,40,171,159,12,268,207,61,15.703,12.061,11.102
21205,Kentucky,Rowan County,24392,36411,30.7,13920,1470,2250,5223,202,202,2409,2147,262,2891,2649,242,1190,1034,156,1116,1006,110,26.724,7.735,3.868
21213,Kentucky,Simpson County,17881,44989,39.8,12102,1176,657,4342,55,174,834,595,239,647,585,62,874,729,145,940,803,137,15.146,5.274,4.007
21217,Kentucky,Taylor County,25406,36455,38.4,16512,1675,1436,6107,126,355,1413,1126,287,1338,1086,252,1260,986,274,1373,1028,345,18.841,7.876,5.813
21049,Kentucky,Clark County,35757,51547,42.3,24963,3608,1800,9335,278,539,1482,1122,360,1295,1200,95,1642,1343,299,1970,1691,279,21.664,8.752,5.774
21219,Kentucky,Todd County,12377,38248,36.8,8075,564,450,3284,115,190,407,287,120,515,340,175,715,515,200,639,473,166,12.557,9.287,5.786
21039,Kentucky,Carlisle County,4890,38860,42.2,3435,318,213,1569,26,91,189,144,45,139,111,28,261,173,88,265,243,22,15.459,7.457,5.8
21041,Kentucky,Carroll County,10695,43345,37.2,7122,504,333,2625,65,137,479,396,83,435,349,86,625,510,115,565,454,111,11.752,7.695,5.219
21053,Kentucky,Clinton County,10208,31130,41.7,7129,397,320,2815,62,110,458,375,83,344,316,28,504,428,76,508,402,106,10.058,6.11,3.908
21065,Kentucky,Estill County,14382,30692,42.6,10241,640,375,3975,97,211,634,477,157,480,398,82,730,534,196,755,696,59,9.911,7.748,5.308
21077,Kentucky,Gallatin County,8652,50250,39,5790,493,198,2145,64,163,374,308,66,269,206,63,403,336,67,471,403,68,11.934,10.583,7.599
21079,Kentucky,Garrard County,17226,47906,42.4,12191,1178,738,5413,223,301,589,357,232,586,538,48,817,657,160,847,703,144,15.717,9.68,5.561
21089,Kentucky,Greenup County,36012,47517,43.3,25554,2660,1730,10740,209,626,1373,1151,222,1315,1136,179,1576,1259,317,1640,1323,317,17.179,7.775,5.829
21069,Kentucky,Fleming County,14515,41095,40.9,9848,756,560,4166,140,207,591,415,176,539,389,150,769,650,119,753,652,101,13.363,8.329,4.969
21037,Kentucky,Campbell County,91804,57208,38,62597,12818,7180,24675,1005,1442,4600,4132,468,4603,4096,507,5531,4875,656,5855,5200,655,31.947,9.917,5.844
21043,Kentucky,Carter County,27385,35095,41.1,18647,1594,1010,8122,323,364,1443,1059,384,1144,921,223,1202,988,214,1388,1172,216,13.965,8.459,4.482
21063,Kentucky,Elliott County,7533,29043,42,5538,240,173,2026,45,101,283,201,82,245,222,23,301,235,66,263,217,46,7.458,7.206,4.985
21081,Kentucky,Grant County,24800,43881,36.5,15908,1233,740,5801,157,338,1037,894,143,858,808,50,1314,1112,202,1445,1259,186,12.403,8.533,5.827
21111,Kentucky,Jefferson County,764378,52237,38,524906,99063,70362,190584,5583,11376,34826,29610,5216,34806,30461,4345,48107,40098,8009,49675,43434,6241,32.277,8.898,5.969
21123,Kentucky,Larue County,14102,41720,40.8,9860,614,590,3951,160,196,559,444,115,513,513,0,684,542,142,713,697,16,12.211,9.01,4.961
21141,Kentucky,Logan County,26847,40982,40.7,18311,1863,845,7265,220,367,1099,909,190,1094,921,173,1308,1073,235,1423,1154,269,14.789,8.08,5.052
21161,Kentucky,Mason County,17167,43082,40.7,11689,1109,1048,4571,83,264,770,569,201,630,589,41,822,683,139,836,743,93,18.453,7.591,5.776
21167,Kentucky,Mercer County,21378,47574,42.8,14944,1406,1138,6206,118,530,832,608,224,914,775,139,1083,935,148,934,880,54,17.024,10.442,8.54
21191,Kentucky,Pendleton County,14530,49706,41.2,10055,721,524,3965,130,322,575,494,81,598,501,97,736,670,66,766,692,74,12.382,11.4,8.121
21201,Kentucky,Robertson County,2161,30694,47.1,1543,205,61,717,20,52,106,90,16,74,66,8,96,96,0,89,77,12,17.239,10.042,7.252
21207,Kentucky,Russell County,17731,34660,43.4,12466,965,710,5338,165,338,663,526,137,656,551,105,796,571,225,921,810,111,13.437,9.423,6.332
21215,Kentucky,Spencer County,18012,68916,40.7,12562,1453,1033,5547,125,257,634,589,45,619,569,50,941,763,178,996,770,226,19.79,6.887,4.633
21229,Kentucky,Washington County,11999,47843,41.2,7983,633,783,3451,30,129,678,553,125,515,424,91,301,236,65,540,504,36,17.738,4.607,3.738
21011,Kentucky,Bath County,12189,38763,39.9,8116,636,312,3298,110,171,471,346,125,485,358,127,524,341,183,633,535,98,11.681,8.52,5.185
21007,Kentucky,Ballard County,8152,42988,43.3,5710,463,340,2532,85,138,319,278,41,295,266,29,342,235,107,369,289,80,14.063,8.807,5.45
21009,Kentucky,Barren County,43418,39658,40.3,29531,2904,1892,11207,404,661,1633,1404,229,1768,1383,385,2359,1855,504,2263,1974,289,16.241,9.503,5.898
21021,Kentucky,Boyle County,29773,43076,40.2,19764,2329,2216,7234,235,520,1739,1346,393,1748,1581,167,1387,1074,313,1233,1129,104,22.996,10.437,7.188
21087,Kentucky,Green County,11044,37388,44.4,7931,488,383,3429,107,175,417,321,96,422,366,56,494,404,90,572,478,94,10.982,8.224,5.104
21091,Kentucky,Hancock County,8700,49135,40.2,5803,365,281,2560,22,51,357,336,21,328,324,4,421,359,62,396,377,19,11.132,2.852,1.992
21095,Kentucky,Harlan County,27548,24451,41.4,19089,1189,980,7694,227,403,1086,919,167,1198,1078,120,1442,1144,298,1386,1107,279,11.363,8.188,5.238
21159,Kentucky,Martin County,12175,29239,39,8547,373,327,3114,42,225,685,612,73,320,226,94,896,691,205,575,474,101,8.19,8.574,7.225
21093,Kentucky,Hardin County,107699,51923,36.1,70244,9288,7239,25297,887,1530,4799,3830,969,4661,4071,590,5790,4892,898,6297,5515,782,23.528,9.554,6.048
21137,Kentucky,Lincoln County,24413,37930,40.6,16843,1062,753,7192,221,255,1065,767,298,960,797,163,1179,831,348,1177,945,232,10.776,6.618,3.546
21149,Kentucky,McLean County,9361,44242,41.5,6476,382,316,3064,72,176,326,306,20,328,274,54,478,425,53,446,359,87,10.778,8.094,5.744
21171,Kentucky,Monroe County,10645,35665,41.8,7414,592,502,3176,19,160,345,290,55,412,387,25,595,453,142,481,362,119,14.756,5.636,5.038
21183,Kentucky,Ohio County,24062,41470,40.7,16486,911,898,6939,157,344,1062,939,123,859,754,105,1172,972,200,1330,1094,236,10.973,7.22,4.957
21197,Kentucky,Powell County,12349,34647,39,8358,575,546,3348,44,200,477,383,94,530,429,101,633,496,137,676,519,157,13.412,7.288,5.974
21225,Kentucky,Union County,14915,42139,37.5,9722,609,492,3755,70,92,1565,1330,235,571,471,100,672,572,100,860,689,171,11.325,4.314,2.45
21233,Kentucky,Webster County,13180,39273,41,9066,542,275,3708,133,99,556,493,63,458,374,84,671,484,187,691,581,110,9.012,6.257,2.67
21033,Kentucky,Caldwell County,12747,46182,42.6,9005,623,862,3870,135,180,439,324,115,448,379,69,543,482,61,871,861,10,16.491,8.14,4.651
21035,Kentucky,Calloway County,38616,39269,34.7,23728,3830,3001,9383,229,570,3428,3051,377,3976,3612,364,2041,1740,301,1896,1491,405,28.789,8.515,6.075
21045,Kentucky,Casey County,15805,33031,43.1,11001,667,692,5120,176,245,605,459,146,551,418,133,758,556,202,772,667,105,12.353,8.223,4.785
21047,Kentucky,Christian County,72438,41849,28.4,41214,3913,3010,12024,288,641,3051,2265,786,3857,3361,496,3706,2807,899,4412,3897,515,16.798,7.726,5.331
21059,Kentucky,Daviess County,99258,48371,39,66803,8843,5602,26700,508,1329,4099,3666,433,4137,3835,302,5259,4293,966,5647,4965,682,21.623,6.88,4.978
21085,Kentucky,Grayson County,26129,35944,40.2,17689,899,846,6902,254,505,1067,845,222,1178,904,274,1360,1183,177,1159,935,224,9.865,10.997,7.317
21101,Kentucky,Henderson County,46252,43458,40.4,31892,2978,2382,11580,306,513,1640,1286,354,1674,1542,132,2386,2042,344,2598,2483,115,16.807,7.073,4.43
21103,Kentucky,Henry County,15677,50787,41.3,10691,701,464,4140,137,257,700,477,223,583,435,148,703,550,153,769,716,53,10.897,9.517,6.208
21107,Kentucky,Hopkins County,45985,44048,41.3,31931,2879,2134,13078,198,651,1697,1333,364,1856,1469,387,2389,2065,324,2437,2116,321,15.699,6.492,4.978
21109,Kentucky,Jackson County,13369,32055,41,9173,550,414,4065,102,194,513,435,78,388,358,30,615,445,170,767,593,174,10.509,7.282,4.772
21125,Kentucky,Laurel County,59901,37235,39.6,40974,3259,2070,15876,485,858,2623,2149,474,2393,2028,365,3029,2233,796,3348,3029,319,13.006,8.459,5.404
21157,Kentucky,Marshall County,31177,49126,44.8,22633,2235,1731,10344,166,443,1088,936,152,965,862,103,1398,1176,222,1598,1282,316,17.523,5.887,4.283
21163,Kentucky,Meade County,28452,53732,37.8,19235,1989,1352,7722,253,390,1081,817,264,1046,843,203,1441,1200,241,1711,1521,190,17.369,8.327,5.051
21173,Kentucky,Montgomery County,27550,42172,39,18653,1836,1329,6964,218,457,1132,878,254,1103,931,172,1573,1118,455,1453,1219,234,16.968,9.693,6.562
21181,Kentucky,Nicholas County,7061,38900,41.6,4810,254,248,1921,52,52,351,311,40,292,252,40,276,203,73,364,243,121,10.437,5.414,2.707
21185,Kentucky,Oldham County,64633,92237,39,42779,10430,6840,17431,524,848,2333,2081,252,1979,1914,65,2402,2032,370,2474,2359,115,40.37,7.871,4.865
21187,Kentucky,Owen County,10686,44031,42.2,7401,479,235,2896,62,177,377,320,57,363,305,58,501,449,52,509,499,10,9.647,8.253,6.112
21203,Kentucky,Rockcastle County,16815,35888,42.2,11794,805,593,4975,184,297,661,576,85,663,546,117,822,615,207,817,748,69,11.853,9.668,5.97
21209,Kentucky,Scott County,52322,65598,36.2,33953,5761,3791,13694,384,485,2528,2154,374,2459,2212,247,2881,2407,474,3212,2701,511,28.133,6.346,3.542
21227,Kentucky,Warren County,123824,49508,32.7,74913,13718,9049,27283,750,1520,9762,8255,1507,9569,8628,941,7173,5825,1348,7270,6309,961,30.391,8.32,5.571
21003,Kentucky,Allen County,20628,40598,40.6,14073,1274,749,5542,171,262,904,699,205,821,641,180,1103,827,276,1063,838,225,14.375,7.813,4.728
21017,Kentucky,Bourbon County,20017,47886,42.1,13912,1712,926,5059,126,310,894,650,244,717,669,48,949,723,226,991,769,222,18.962,8.618,6.128
21019,Kentucky,Boyd County,48486,45543,41.9,34571,4012,2686,13360,327,756,1718,1335,383,1758,1424,334,2564,2040,524,2616,2215,401,19.375,8.106,5.659
21029,Kentucky,Bullitt County,78622,59917,39.8,54121,4923,2613,23681,648,1454,3494,3090,404,3126,2964,162,4221,3548,673,4371,4146,225,13.924,8.876,6.14
21055,Kentucky,Crittenden County,9154,41114,43.2,6428,505,348,3015,80,230,335,256,79,296,235,61,441,338,103,407,321,86,13.27,10.282,7.629
21067,Kentucky,Fayette County,315109,53013,34.3,203859,48624,36661,68819,1653,3755,22032,19138,2894,22617,20479,2138,21518,17198,4320,20937,17907,3030,41.835,7.858,5.456
21075,Kentucky,Fulton County,6259,28274,43.1,4408,382,274,1506,6,73,219,152,67,283,212,71,269,217,52,291,271,20,14.882,5.246,4.847
21115,Kentucky,Johnson County,23064,35629,41.9,16083,1410,1017,6342,107,215,964,778,186,975,803,172,1122,912,210,1127,999,128,15.09,5.077,3.39
21119,Kentucky,Knott County,15690,30503,41.4,10785,619,767,4727,66,155,810,661,149,741,564,177,679,545,134,757,713,44,12.851,4.675,3.279
21165,Kentucky,Menifee County,6381,39688,46.2,4668,338,192,2085,30,87,212,179,33,179,168,11,431,349,82,302,275,27,11.354,5.612,4.173
21175,Kentucky,Morgan County,13281,33523,41.3,9834,644,554,3682,106,133,508,418,90,380,337,43,579,466,113,625,579,46,12.182,6.491,3.612
21177,Kentucky,Muhlenberg County,31153,40037,42,21552,1306,1126,8885,201,283,1555,1382,173,1254,1084,170,1265,892,373,1607,1303,304,11.284,5.447,3.185
21193,Kentucky,Perry County,27329,31820,41.2,19143,1120,1289,8117,161,454,1156,793,363,1085,931,154,1386,1180,206,1482,1392,90,12.584,7.577,5.593
21199,Kentucky,Pulaski County,63974,35022,42,44738,4059,2751,17852,567,1333,2748,2276,472,2480,2048,432,3072,2483,589,3401,3092,309,15.222,10.643,7.467
21237,Kentucky,Wolfe County,7251,21999,41.8,5045,194,197,1851,37,157,264,210,54,249,222,27,375,327,48,289,289,0,7.75,10.481,8.482
21051,Kentucky,Clay County,20866,24596,39.2,14739,755,647,5505,176,296,772,512,260,622,532,90,1263,912,351,1198,1041,157,9.512,8.574,5.377
21001,Kentucky,Adair County,19304,36575,40.8,12861,997,1035,5400,143,251,1123,906,217,1124,1068,56,911,758,153,894,798,96,15.8,7.296,4.648
21013,Kentucky,Bell County,27469,23558,41.6,19355,897,904,7187,140,498,1089,817,272,1054,915,139,1319,1173,146,1575,1425,150,9.305,8.877,6.929
21025,Kentucky,Breathitt County,13276,25861,41.2,9298,556,617,3904,76,185,599,463,136,621,552,69,735,657,78,648,598,50,12.616,6.685,4.739
21057,Kentucky,Cumberland County,6744,35449,45.1,4742,408,217,1902,58,163,282,128,154,231,200,31,290,236,54,293,228,65,13.18,11.619,8.57
21083,Kentucky,Graves County,37259,40369,40.3,25225,2444,1647,10558,167,487,1552,1244,308,1342,1159,183,1845,1502,343,1872,1685,187,16.218,6.194,4.613
21099,Kentucky,Hart County,18531,37315,40.6,12494,889,681,5456,200,214,764,536,228,701,637,64,887,655,232,859,642,217,12.566,7.588,3.922
21129,Kentucky,Lee County,6717,23297,44.2,4943,195,247,2089,16,151,105,56,49,144,115,29,206,173,33,352,326,26,8.942,7.994,7.228
22113,Louisiana,Vermilion Parish,59841,49266,36.9,39293,3570,1182,16623,212,482,2266,1509,757,2532,1964,568,3428,2592,836,3562,2892,670,12.094,4.175,2.9
22089,Louisiana,St. Charles Parish,52728,64707,37.2,34811,5842,1905,15206,513,793,2380,1805,575,2266,1815,451,2771,1930,841,3012,2526,486,22.254,8.589,5.215
22057,Louisiana,Lafourche Parish,98112,52705,37.1,65714,7468,3238,27163,549,964,4401,3387,1014,4723,3934,789,6040,4496,1544,6293,5032,1261,16.292,5.57,3.549
22029,Louisiana,Concordia Parish,20211,30028,37.7,13563,1106,434,4722,105,323,853,411,442,862,414,448,603,515,88,927,787,140,11.354,9.064,6.84
22107,Louisiana,Tensas Parish,4771,21906,44,3267,218,99,1197,29,54,136,75,61,154,111,43,259,127,132,148,100,48,9.703,6.934,4.511
22125,Louisiana,West Feliciana Parish,15376,55647,40.5,10499,1510,902,2903,15,65,834,767,67,406,274,132,612,531,81,404,351,53,22.974,2.756,2.239
22053,Louisiana,Jefferson Davis Parish,31405,40744,38.1,20717,2084,1180,8170,123,335,1331,1040,291,1249,987,262,1671,1212,459,1852,1492,360,15.755,5.606,4.1
22093,Louisiana,St. James Parish,21485,52055,38.9,14532,1435,598,6108,211,204,1010,759,251,1029,719,310,1252,897,355,1269,1106,163,13.99,6.794,3.34
22043,Louisiana,Grant Parish,22305,40577,37.7,15688,924,402,4853,116,104,904,602,302,722,676,46,1067,810,257,1100,934,166,8.452,4.533,2.143
22051,Louisiana,Jefferson Parish,437038,50868,39,305277,51200,25645,104407,4042,7733,19215,13359,5856,19669,14926,4743,28196,19558,8638,28322,22135,6187,25.172,11.278,7.407
22011,Louisiana,Beauregard Parish,36598,47350,37.5,24302,2804,1161,10189,116,328,1929,1420,509,1487,1231,256,2049,1439,610,1914,1415,499,16.316,4.358,3.219
22013,Louisiana,Bienville Parish,13806,34077,42.3,9614,751,439,4207,80,102,523,316,207,617,470,147,734,481,253,696,567,129,12.378,4.326,2.425
22015,Louisiana,Bossier Parish,125698,52145,34.9,82058,13583,7495,30303,1204,1842,4690,3419,1271,5547,4660,887,7361,5704,1657,8292,6857,1435,25.687,10.052,6.079
22023,Louisiana,Cameron Parish,6806,60194,43.2,4718,469,98,2414,43,24,219,163,56,283,274,9,290,255,35,279,252,27,12.018,2.775,0.994
22037,Louisiana,East Feliciana Parish,19553,46964,42.4,14115,1236,466,5502,125,216,633,441,192,605,453,152,683,450,233,934,652,282,12.058,6.198,3.926
22095,Louisiana,St. John the Baptist Parish,43565,53628,36.5,28678,3382,1314,11728,445,757,2383,1723,660,1657,1331,326,2391,1605,786,2752,2124,628,16.375,10.249,6.455
22075,Louisiana,Plaquemines Parish,23394,49635,35.9,15233,2074,862,6046,152,351,758,633,125,921,783,138,1280,902,378,1519,1268,251,19.274,8.32,5.805
22073,Louisiana,Ouachita Parish,156433,40081,35.1,100338,16303,8103,33710,1123,1454,6828,4766,2062,8458,6566,1892,7979,5730,2249,9917,7551,2366,24.324,7.645,4.313
22079,Louisiana,Rapides Parish,132080,42655,37.3,86803,11153,6280,29438,519,1323,5684,4112,1572,5321,4199,1122,7101,5026,2075,8014,6521,1493,20.083,6.257,4.494
22117,Louisiana,Washington Parish,46449,32962,39.9,31449,2511,1327,12545,426,728,1836,1101,735,1778,1103,675,2204,1576,628,2559,1970,589,12.204,9.199,5.803
22097,Louisiana,St. Landry Parish,83580,32163,36.2,53648,4940,2314,21254,523,1326,3543,1926,1617,3578,2457,1121,4160,3316,844,4957,3889,1068,13.521,8.7,6.239
22105,Louisiana,Tangipahoa Parish,128850,45901,34.9,82990,11679,4820,32452,855,1821,6720,5048,1672,6873,5813,1060,8140,5225,2915,8611,6837,1774,19.881,8.246,5.611
22001,Louisiana,Acadia Parish,62607,40492,35.8,40193,3350,1554,16177,352,510,2879,2103,776,2822,2017,805,3488,2592,896,3730,2794,936,12.201,5.329,3.153
22101,Louisiana,St. Mary Parish,52578,41345,38,35118,2649,1085,12515,247,464,2414,1820,594,2287,1733,554,2781,1941,840,3115,2338,777,10.633,5.681,3.708
22123,Louisiana,West Carroll Parish,11274,37304,41,7731,550,374,3105,42,51,388,253,135,410,297,113,482,265,217,600,391,209,11.952,2.995,1.643
22103,Louisiana,St. Tammany Parish,249201,66539,39.8,169108,35597,19433,71409,2861,4596,9300,6882,2418,8613,7170,1443,11915,8891,3024,13820,11096,2724,32.541,10.443,6.436
22111,Louisiana,Union Parish,22537,38916,41.7,15586,1393,597,6506,42,268,805,657,148,910,572,338,1051,711,340,1144,915,229,12.768,4.765,4.119
22021,Louisiana,Caldwell Parish,10000,31933,39.9,6804,575,266,2712,55,136,346,244,102,383,297,86,464,348,116,503,333,170,12.36,7.043,5.015
22017,Louisiana,Caddo Parish,251069,40391,37.1,167590,25380,14781,58413,1800,4192,11230,7940,3290,11760,9193,2567,14369,10750,3619,16558,12726,3832,23.964,10.258,7.176
22035,Louisiana,East Carroll Parish,7318,20795,33.8,4819,359,112,1091,15,39,121,44,77,325,184,141,96,57,39,273,267,6,9.774,4.95,3.575
22005,Louisiana,Ascension Parish,119129,74748,35.3,76658,14763,6358,33582,648,1719,5468,4015,1453,5042,4141,901,6969,5920,1049,7390,6494,896,27.552,7.048,5.119
22055,Louisiana,Lafayette Parish,238230,53950,34.5,157351,34741,15263,58780,1788,3191,12327,9670,2657,12601,10185,2416,17996,13921,4075,17567,13927,3640,31.779,8.471,5.429
22039,Louisiana,Evangeline Parish,33750,31745,35.4,21672,2082,711,7929,95,390,1782,996,786,1384,1118,266,1662,1289,373,1865,1543,322,12.888,6.117,4.919
22045,Louisiana,Iberia Parish,73346,44504,36,47244,4234,1761,17736,553,795,3328,2186,1142,3598,2877,721,4102,3009,1093,3988,2956,1032,12.689,7.6,4.482
22061,Louisiana,Lincoln Parish,47536,34424,27.6,25668,5403,3887,9465,123,237,5729,4491,1238,6084,4872,1212,2648,1950,698,2507,2117,390,36.193,3.803,2.504
22087,Louisiana,St. Bernard Parish,45067,45265,33.6,29010,2776,724,10006,410,594,2063,1573,490,2049,1582,467,3109,2353,756,3541,3070,471,12.065,10.034,5.936
22091,Louisiana,St. Helena Parish,10509,35254,38.3,7212,410,397,3303,112,151,557,335,222,536,387,149,449,264,185,522,460,62,11.19,7.962,4.572
22119,Louisiana,Webster Parish,40043,30891,40.6,27475,3068,1179,11102,295,667,1589,998,591,1636,1219,417,2095,1451,644,2209,1562,647,15.458,8.665,6.008
22121,Louisiana,West Baton Rouge Parish,25518,60902,35.6,17048,2304,1120,6928,149,199,1170,904,266,1180,1017,163,1547,1191,356,1887,1661,226,20.084,5.023,2.872
22031,Louisiana,De Soto Parish,27164,41443,39.4,18322,1655,825,7531,155,452,1087,662,425,1040,799,241,1316,1049,267,1603,1132,471,13.536,8.06,6.002
22047,Louisiana,Iberville Parish,33122,47128,38.4,22986,2470,968,8445,143,554,1331,878,453,1389,1084,305,1896,1206,690,1791,1625,166,14.957,8.253,6.56
22081,Louisiana,Red River Parish,8723,41510,39.9,5790,542,364,2516,70,116,415,141,274,430,310,120,373,290,83,373,319,54,15.648,7.393,4.61
22063,Louisiana,Livingston Parish,137096,60456,35.9,89530,11035,4550,39087,982,1617,5510,4421,1089,5836,5023,813,8484,6599,1885,8943,7305,1638,17.408,6.649,4.137
22067,Louisiana,Morehouse Parish,26290,31672,39.6,17490,1896,528,6654,107,278,1260,779,481,1131,820,311,946,755,191,1370,1021,349,13.859,5.786,4.178
22069,Louisiana,Natchitoches Parish,39051,29001,33.6,23158,2867,1627,7275,148,337,2759,1968,791,3320,2399,921,1610,1037,573,1963,1507,456,19.406,6.667,4.632
22071,Louisiana,Orleans Parish,388182,38721,35.9,271570,56258,42812,72892,2963,8163,18274,14569,3705,21374,17821,3553,29467,22570,6897,33655,27846,5809,36.48,15.264,11.199
22109,Louisiana,Terrebonne Parish,113067,47650,35.5,73719,7936,2708,28575,756,1410,5406,3832,1574,5376,4384,992,6908,4897,2011,7183,5730,1453,14.439,7.58,4.934
22025,Louisiana,Catahoula Parish,10044,34470,38,6852,733,219,2823,71,175,399,266,133,353,193,160,487,313,174,453,396,57,13.894,8.714,6.199
22019,Louisiana,Calcasieu Parish,198753,48219,36.1,130718,19062,9334,52140,1338,2140,9509,6402,3107,9695,7657,2038,12056,8760,3296,13114,9937,3177,21.723,6.671,4.104
22027,Louisiana,Claiborne Parish,16296,26877,42.2,11928,1102,562,3974,32,273,797,522,275,566,447,119,944,633,311,593,416,177,13.95,7.675,6.87
22041,Louisiana,Franklin Parish,20388,34722,38,13488,1037,504,5184,85,178,683,460,223,828,610,218,700,473,227,1067,795,272,11.425,5.073,3.434
22009,Louisiana,Avoyelles Parish,41095,36763,38.1,27863,2219,924,10431,247,452,1344,810,534,1536,1268,268,1882,1473,409,2334,1828,506,11.28,6.701,4.333
22007,Louisiana,Assumption Parish,22881,48656,39.5,15572,1070,540,6895,150,196,1154,878,276,889,680,209,1137,674,463,1244,1050,194,10.339,5.018,2.843
22049,Louisiana,Jackson Parish,15952,36394,40.5,11212,1030,428,4259,134,250,643,437,206,592,523,69,587,435,152,862,693,169,13.004,9.016,5.87
22033,Louisiana,East Baton Rouge Parish,446167,51436,33.4,279844,60801,35689,98239,2654,6533,31678,25088,6590,33202,27383,5819,29414,21943,7471,28984,24068,4916,34.48,9.352,6.65
22077,Louisiana,Pointe Coupee Parish,22271,43964,42.7,15416,1728,707,6715,211,322,870,559,311,896,658,238,1113,856,257,1179,903,276,15.795,7.937,4.795
22083,Louisiana,Richland Parish,20619,34745,38.2,13873,1379,752,4752,111,123,822,330,492,728,503,225,1113,572,541,1156,837,319,15.361,4.924,2.588
22099,Louisiana,St. Martin Parish,53609,47279,37.1,35653,3834,1227,15501,427,963,2246,1621,625,2285,2002,283,3362,2242,1120,3309,2604,705,14.195,8.967,6.213
22115,Louisiana,Vernon Parish,51906,46620,30.1,31124,3841,1662,9399,226,352,3121,2365,756,2651,2419,232,2775,2018,757,3499,3015,484,17.681,6.15,3.745
22127,Louisiana,Winn Parish,14631,29472,40.9,10250,911,430,3508,56,93,469,254,215,525,434,91,531,298,233,663,497,166,13.083,4.247,2.651
22085,Louisiana,Sabine Parish,24145,40695,41.3,16495,1571,764,6803,87,184,1044,723,321,901,630,271,1184,682,502,1296,999,297,14.156,3.984,2.705
22003,Louisiana,Allen Parish,25667,42176,38.2,17898,1424,928,5948,97,224,1004,699,305,862,666,196,1239,1033,206,1204,941,263,13.141,5.397,3.766
22065,Louisiana,Madison Parish,11616,29424,35.1,7691,698,333,2287,20,92,394,192,202,359,186,173,483,324,159,623,444,179,13.405,4.897,4.023
22059,Louisiana,LaSalle Parish,14930,34712,38.2,10033,939,287,3730,65,135,610,429,181,507,393,114,759,607,152,796,677,119,12.22,5.362,3.619
23009,Maine,Hancock County,54468,51438,48.1,41108,7879,5422,17455,643,1183,2104,1796,308,1780,1388,392,2564,1582,982,2674,2101,573,32.356,10.461,6.777
23017,Maine,Oxford County,57230,44582,46.3,41940,5125,2760,16593,605,1117,2108,1563,545,1695,1349,346,2499,1802,697,2782,2395,387,18.801,10.378,6.732
23015,Maine,Lincoln County,34021,54041,50.5,26018,4875,3734,11941,387,1043,1054,752,302,943,763,180,1345,903,442,1417,1134,283,33.089,11.976,8.735
23027,Maine,Waldo County,39280,50162,45.7,28776,5596,3112,13427,362,877,1380,1093,287,1483,1235,248,1863,1391,472,1828,1416,412,30.261,9.228,6.532
23019,Maine,Penobscot County,152284,47886,41.8,106947,17833,10217,43132,1559,2533,8307,7141,1166,7950,6945,1005,9087,7103,1984,8548,7098,1450,26.228,9.487,5.873
23021,Maine,Piscataquis County,16960,38797,50.7,12933,1599,707,5699,219,389,542,373,169,503,432,71,649,462,187,625,482,143,17.83,10.669,6.826
23001,Maine,Androscoggin County,107317,49538,40.7,74251,10984,5445,28953,1258,1569,4559,3763,796,4625,3629,996,5691,4587,1104,6035,5355,680,22.126,9.764,5.419
23003,Maine,Aroostook County,68840,39021,47.2,50614,6514,2851,21394,715,1188,2682,2226,456,2514,2183,331,2941,2422,519,2919,2594,325,18.503,8.895,5.553
23029,Maine,Washington County,31822,40328,47.6,23436,3210,1695,10604,351,609,1165,858,307,1062,838,224,1283,878,405,1406,1157,249,20.929,9.053,5.743
23005,Maine,Cumberland County,289173,65702,42.1,207097,58303,34943,81526,3260,6711,13186,11188,1998,13101,11515,1586,15944,13271,2673,16614,15033,1581,45.025,12.23,8.232
23013,Maine,Knox County,39700,53117,47.8,29829,5873,3227,12983,617,933,1327,985,342,1050,957,93,1626,1100,526,1812,1382,430,30.507,11.939,7.186
23023,Maine,Sagadahoc County,35149,60457,45.9,25875,5701,3222,11980,398,897,1183,922,261,1241,1077,164,1685,1503,182,1786,1579,207,34.485,10.81,7.487
23031,Maine,York County,201454,62618,44.7,146371,30093,15097,62103,2617,5053,7331,6049,1282,7485,6457,1028,10220,7978,2242,10449,8933,1516,30.874,12.35,8.136
23011,Maine,Kennebec County,121289,50116,44.2,86934,14228,8958,35827,1066,1947,5044,4357,687,4997,4461,536,5977,5114,863,6240,5625,615,26.671,8.41,5.434
23007,Maine,Franklin County,30177,45541,45.4,21506,3601,2002,9237,351,570,1427,1152,275,1568,1378,190,1397,1131,266,1436,1193,243,26.053,9.971,6.171
23025,Maine,Somerset County,50994,41549,45.8,37451,4418,1803,16288,434,847,1785,1318,467,1638,1259,379,2227,1765,462,2448,2070,378,16.611,7.865,5.2
24047,Maryland,Worcester County,51559,59458,49.7,38930,7439,4260,15774,765,1519,1786,1546,240,1676,1508,168,2023,1621,402,2160,1962,198,30.051,14.48,9.63
24510,Maryland,Baltimore city,619796,46641,35,425235,67779,61584,113558,5210,11763,32643,28584,4059,37040,33294,3746,46321,39105,7216,53182,48939,4243,30.422,14.947,10.359
24039,Maryland,Somerset County,25801,39239,37,17070,1617,845,5405,200,567,1720,1590,130,1716,1608,108,534,422,112,1174,1076,98,14.423,14.191,10.49
24041,Maryland,Talbot County,37461,65595,49.7,28077,5448,5045,11599,430,981,1142,1024,118,1167,1096,71,1698,1246,452,1672,1462,210,37.372,12.165,8.458
24025,Maryland,Harford County,250132,83445,40.6,172031,36150,24325,73027,2713,5336,9980,8928,1052,9966,9384,582,13734,12411,1323,13768,13014,754,35.154,11.022,7.307
24001,Maryland,Allegany County,72591,42771,41.5,50489,4888,4310,19110,499,988,4305,3911,394,3853,3642,211,3551,2900,651,3240,3066,174,18.218,7.781,5.17
24027,Maryland,Howard County,312495,115576,38.7,210338,63325,65448,82082,2873,5484,12942,12034,908,12233,11083,1150,16091,14313,1778,17357,16101,1256,61.222,10.181,6.681
24033,Maryland,Prince George's County,905161,78607,36.5,607229,110917,82559,189513,10483,19778,47738,38767,8971,46544,40067,6477,59222,41412,17810,59768,49306,10462,31.862,15.968,10.436
24003,Maryland,Anne Arundel County,564600,94502,38.5,387306,90536,64861,152576,6283,11778,22723,19593,3130,21803,20223,1580,31871,27951,3920,34776,31517,3259,40.123,11.837,7.719
24005,Maryland,Baltimore County,828637,71810,39.2,573263,125363,91430,205962,7587,14914,38116,32707,5409,38644,35322,3322,48368,40663,7705,53562,47715,5847,37.817,10.925,7.241
24021,Maryland,Frederick County,246105,88502,39.3,166221,39146,28096,67295,2515,4995,10715,9644,1071,10049,9536,513,13205,11729,1476,13778,12781,997,40.453,11.16,7.423
24009,Maryland,Calvert County,90824,100350,40.8,61269,10564,7866,26241,1023,2146,4063,3499,564,3362,2889,473,3967,3475,492,4322,4145,177,30.08,12.077,8.178
24023,Maryland,Garrett County,29516,48174,45.4,21378,2244,1948,9199,338,565,1348,1194,154,1137,995,142,1328,1070,258,1361,1234,127,19.609,9.816,6.142
24029,Maryland,Kent County,19666,56638,46.9,13932,2644,1987,5332,167,479,1177,990,187,1378,1293,85,842,608,234,764,620,144,33.24,12.116,8.983
24031,Maryland,Montgomery County,1039198,103178,38.8,713454,190725,225463,242295,9743,19590,40827,33952,6875,40509,34934,5575,60000,48449,11551,63361,54156,9205,58.334,12.106,8.085
24013,Maryland,Carroll County,167319,90510,42.4,115213,25023,14838,49447,1809,3100,7397,6970,427,7144,6921,223,8063,7263,800,7566,6990,576,34.598,9.928,6.269
24035,Maryland,Queen Anne's County,49071,89241,44.1,34452,7377,4780,14587,820,1088,1874,1749,125,1748,1603,145,2093,1733,360,2259,2098,161,35.287,13.08,7.459
24037,Maryland,St. Mary's County,110979,86508,36.5,73031,13009,9223,28257,1154,1695,4719,4341,378,4745,4332,413,6338,5362,976,6746,6314,432,30.442,10.082,5.999
24017,Maryland,Charles County,156021,93973,38.1,103318,17540,11904,42505,2318,4240,6706,6143,563,7047,6719,328,7732,6829,903,8804,8376,428,28.498,15.429,9.975
24019,Maryland,Dorchester County,32386,50532,44.4,23131,2926,1728,8518,348,796,1169,1082,87,1362,1276,86,1625,1366,259,1646,1462,184,20.12,13.43,9.345
24043,Maryland,Washington County,149546,58260,40.6,103916,13451,8843,36117,1175,2558,5761,5168,593,5445,4868,577,7122,5770,1352,7848,6945,903,21.454,10.336,7.083
24045,Maryland,Wicomico County,102014,54493,35.8,63959,10373,7398,22709,733,1835,6572,5749,823,7573,6759,814,5362,4052,1310,5628,4921,707,27.785,11.308,8.08
24015,Maryland,Cecil County,102416,70516,40.3,69969,9632,6462,27110,1076,1906,4526,3877,649,4194,3845,349,5327,4718,609,5761,5238,523,23.002,11,7.031
24011,Maryland,Caroline County,32785,52469,40.1,22216,2182,1496,8540,444,909,1320,964,356,1333,1185,148,1739,1341,398,1706,1499,207,16.556,15.843,10.644
25025,Massachusetts,Suffolk County,780685,61242,32.6,536354,130501,103484,110361,5352,13814,58269,53736,4533,62683,60167,2516,75275,69160,6115,77792,74780,3012,43.625,17.367,12.517
25001,Massachusetts,Barnstable County,213900,68048,52.4,165101,39428,29419,74862,3647,8044,8271,7810,461,6318,5909,409,8246,7288,958,8502,7970,532,41.7,15.617,10.745
25007,Massachusetts,Dukes County,17275,67535,45.9,12727,3591,2301,4770,164,880,499,482,17,580,515,65,892,849,43,772,739,33,46.295,21.887,18.449
25017,Massachusetts,Middlesex County,1582857,92878,38.5,1106543,297546,301153,371697,14124,29049,77707,73473,4234,76797,74202,2595,106273,99096,7177,107022,103259,3763,54.105,11.615,7.815
25003,Massachusetts,Berkshire County,127751,55190,46.5,92897,16997,13831,37987,1547,3020,5868,5552,316,6119,5949,170,5809,5260,549,5842,5661,181,33.185,12.023,7.95
25005,Massachusetts,Bristol County,557016,62514,40.9,387417,66555,39283,135144,5331,11862,26053,24053,2000,25875,24652,1223,30110,27432,2678,31208,29975,1233,27.319,12.722,8.777
25013,Massachusetts,Hampden County,469188,52205,38.7,314809,49416,33876,109475,4985,7666,24641,22486,2155,23766,22415,1351,26255,23391,2864,27488,26502,986,26.458,11.556,7.003
25023,Massachusetts,Plymouth County,509114,82081,42.6,352035,79833,45718,139821,6582,13094,21473,20296,1177,20840,19931,909,23124,20969,2155,24023,23103,920,35.664,14.072,9.365
25009,Massachusetts,Essex County,775860,73533,40.8,534288,124302,83083,186007,8731,16916,35330,32014,3316,35369,33486,1883,40941,36145,4796,41967,40336,1631,38.815,13.788,9.094
25011,Massachusetts,Franklin County,70926,57307,45.9,52862,9936,9494,21024,896,1657,2686,2560,126,2669,2557,112,3747,3464,283,3731,3579,152,36.756,12.143,7.881
25021,Massachusetts,Norfolk County,694389,95668,41,485216,138379,116394,181881,7824,14237,29206,28067,1139,30608,29586,1022,36310,34057,2253,39825,38622,1203,52.507,12.129,7.828
25027,Massachusetts,Worcester County,818249,69313,40.1,559286,120813,76804,198010,7369,14980,39721,37591,2130,38019,36331,1688,44177,40630,3547,45004,43533,1471,35.334,11.287,7.565
25015,Massachusetts,Hampshire County,161197,64974,36.1,99070,22348,22798,38852,1552,2789,14848,14134,714,18438,17988,450,7534,6742,792,7653,7359,294,45.57,11.173,7.179
25019,Massachusetts,Nantucket County,10912,91942,39.8,7931,1960,1618,2438,161,318,477,477,0,360,344,16,812,676,136,687,636,51,45.114,19.647,13.043
26021,Michigan,Berrien County,154948,47132,42,107173,16928,11703,43694,1391,2608,6675,5053,1622,6271,5515,756,7799,6110,1689,7962,6973,989,26.715,9.152,5.969
26129,Michigan,Ogemaw County,20979,38149,49.7,15616,1180,657,7694,305,570,706,484,222,708,604,104,840,707,133,848,750,98,11.764,11.372,7.408
26135,Michigan,Oscoda County,8304,36833,51.8,6187,445,230,3170,126,281,256,160,96,261,162,99,325,197,128,318,243,75,10.91,12.839,8.864
26165,Michigan,Wexford County,32915,42793,41.9,22725,2786,1213,10006,407,617,1303,1061,242,1265,938,327,1667,1182,485,1679,1444,235,17.597,10.234,6.166
26039,Michigan,Crawford County,13821,42666,50,10296,1215,592,4856,176,277,504,390,114,445,352,93,480,427,53,555,455,100,17.551,9.329,5.704
26037,Michigan,Clinton County,77321,64903,40.4,52473,10524,6019,23128,555,1004,3578,3200,378,3341,3173,168,3850,3473,377,3985,3774,211,31.527,6.741,4.341
26043,Michigan,Dickinson County,25694,45681,46.4,18634,3280,1463,8776,132,420,986,773,213,827,752,75,1233,937,296,1205,1098,107,25.453,6.29,4.786
26057,Michigan,Gratiot County,41319,42256,39,28089,2478,1658,10718,306,411,2002,1744,258,1922,1696,226,1592,1329,263,1948,1709,239,14.725,6.69,3.835
26063,Michigan,Huron County,31750,45191,48.5,23306,2414,1210,11330,357,481,1183,920,263,1020,892,128,1414,1102,312,1252,1085,167,15.55,7.396,4.245
26065,Michigan,Ingham County,286185,49109,31.7,171795,35536,30497,65175,1689,3852,26623,23611,3012,26897,24455,2442,17281,14461,2820,17366,15594,1772,38.437,8.502,5.91
26091,Michigan,Lenawee County,98585,51339,41.6,67861,9067,4857,29599,1018,1865,4389,3883,506,4218,3733,485,4808,3850,958,4641,4005,636,20.518,9.74,6.301
26105,Michigan,Mason County,28800,45524,46,20668,2853,1735,9398,373,659,1227,989,238,945,794,151,1277,1021,256,1321,1175,146,22.199,10.981,7.012
26109,Michigan,Menominee County,23389,44480,48,17240,1920,809,8356,229,400,840,687,153,768,723,45,1038,890,148,957,801,156,15.829,7.528,4.787
26117,Michigan,Montcalm County,62956,44651,40.5,43357,3807,1738,18347,570,1244,2334,1870,464,2381,2060,321,3076,2414,662,3146,2686,460,12.789,9.887,6.78
26113,Michigan,Missaukee County,14982,42370,43.4,10377,931,462,4870,152,339,557,463,94,500,407,93,764,558,206,731,583,148,13.424,10.082,6.961
26149,Michigan,St. Joseph County,60890,47856,39.4,40694,3921,2349,17639,546,902,2510,2095,415,2321,2033,288,3253,2629,624,3182,2757,425,15.408,8.209,5.114
26147,Michigan,St. Clair County,159761,53641,43.2,112002,12806,7372,49024,1429,2976,6601,5359,1242,6230,5518,712,7567,6143,1424,7589,6614,975,18.016,8.985,6.07
26159,Michigan,Van Buren County,75190,49119,41.6,51079,6929,3608,22508,706,1252,3141,2321,820,2663,2409,254,3569,2779,790,3717,3250,467,20.629,8.699,5.562
26161,Michigan,Washtenaw County,361509,65618,33.4,223988,57485,64209,83645,2685,5061,32346,29729,2617,30342,28138,2204,22654,20253,2401,21260,19704,1556,54.331,9.261,6.051
26011,Michigan,Arenac County,15238,39947,49.3,11391,846,477,5507,185,342,580,411,169,469,381,88,624,488,136,667,586,81,11.614,9.57,6.21
26015,Michigan,Barry County,59607,57312,42.7,41495,5549,2546,18902,508,1047,2195,1995,200,2111,1956,155,3080,2391,689,2878,2537,341,19.508,8.227,5.539
26027,Michigan,Cass County,51397,50699,44.7,36347,4402,2170,16646,589,1063,1998,1542,456,1834,1610,224,2317,1821,496,2260,1963,297,18.081,9.924,6.386
26071,Michigan,Iron County,11291,36773,53.8,8805,1099,532,4392,118,256,314,243,71,288,203,85,389,301,88,424,390,34,18.524,8.515,5.829
26019,Michigan,Benzie County,17462,53185,48.9,13010,2224,1502,6079,246,418,699,464,235,494,463,31,690,497,193,696,605,91,28.64,10.923,6.876
26143,Michigan,Roscommon County,23934,37834,55.3,18974,1673,1018,9077,298,758,621,494,127,639,547,92,800,567,233,891,745,146,14.183,11.634,8.351
26153,Michigan,Schoolcraft County,8114,37428,51.1,6070,628,294,2592,124,180,234,185,49,217,193,24,269,245,24,279,254,25,15.189,11.728,6.944
26163,Michigan,Wayne County,1763822,43702,37.9,1173262,161102,106678,418914,11608,27533,85348,67895,17453,86887,74805,12082,97473,76036,21437,103590,90729,12861,22.824,9.343,6.572
26023,Michigan,Branch County,43543,48192,41.2,30031,2927,1281,12376,429,671,1526,1203,323,1671,1383,288,2222,1792,430,2106,1807,299,14.012,8.888,5.422
26055,Michigan,Grand Traverse County,91222,58229,42.8,65378,13632,8749,27991,1170,1736,3543,2925,618,3342,2966,376,5148,4374,774,5262,4558,704,34.233,10.382,6.202
26075,Michigan,Jackson County,158989,49715,41,109293,15798,7275,44932,1254,2652,6657,5519,1138,6710,5916,794,7346,5816,1530,7973,7022,951,21.111,8.693,5.902
26097,Michigan,Mackinac County,10836,42559,51.8,8305,992,592,3798,123,307,411,244,167,359,257,102,410,249,161,441,358,83,19.073,11.322,8.083
26049,Michigan,Genesee County,410881,45231,40.1,278229,35525,21286,117034,3550,7846,18580,15662,2918,18598,16307,2291,20226,15806,4420,22008,19674,2334,20.419,9.737,6.704
26009,Michigan,Antrim County,23133,50988,50.4,17252,2830,1815,8243,276,659,730,612,118,692,563,129,892,645,247,904,770,134,26.924,11.343,7.995
26061,Michigan,Houghton County,36333,41379,32.9,21194,4172,2794,9013,191,386,4689,4028,661,2276,2095,181,1777,1476,301,1517,1344,173,32.868,6.402,4.283
26093,Michigan,Livingston County,186946,78430,42.9,129271,29548,15311,60469,1827,4022,7627,6794,833,6882,6147,735,8777,7648,1129,8475,7736,739,34.702,9.673,6.651
26069,Michigan,Iosco County,25317,41414,52.6,19446,1998,1235,9179,222,506,749,576,173,746,675,71,1021,746,275,913,795,118,16.626,7.931,5.513
26085,Michigan,Lake County,11669,32309,52.1,8943,643,375,3844,122,342,377,330,47,353,300,53,321,224,97,448,368,80,11.383,12.071,8.897
26101,Michigan,Manistee County,24432,44882,48.7,18164,2342,1385,8069,333,462,730,590,140,765,650,115,970,733,237,866,739,127,20.519,9.853,5.726
26119,Michigan,Montmorency County,9290,39152,55.3,7399,580,306,3597,149,291,243,150,93,230,204,26,283,203,80,313,279,34,11.975,12.232,8.09
26141,Michigan,Presque Isle County,12854,43758,54.3,10009,975,648,5175,124,217,396,278,118,316,251,65,377,285,92,406,306,100,16.215,6.589,4.193
26051,Michigan,Gladwin County,25324,40871,49.5,18735,1512,1028,9184,316,711,958,705,253,740,581,159,926,611,315,967,817,150,13.558,11.182,7.742
26077,Michigan,Kalamazoo County,259830,51945,34.1,161274,35464,24549,65184,2033,3082,20368,17786,2582,20484,18328,2156,15195,12471,2724,14584,13083,1501,37.212,7.847,4.728
26107,Michigan,Mecosta County,43181,43470,36.4,26634,3540,2245,11567,337,718,4199,3767,432,3592,3363,229,1934,1586,348,1886,1656,230,21.72,9.121,6.207
26103,Michigan,Marquette County,67145,48491,39.1,44536,9257,4449,18328,424,963,4870,4267,603,5032,4655,377,3183,2540,643,3216,2780,436,30.775,7.568,5.254
26123,Michigan,Newaygo County,47899,45645,42.6,33101,3325,1634,15511,464,988,1860,1569,291,1739,1573,166,2310,1837,473,2340,2108,232,14.981,9.361,6.37
26133,Michigan,Osceola County,23221,41099,43.5,16105,1303,696,7312,282,427,899,716,183,802,658,144,1117,897,220,1031,876,155,12.412,9.696,5.84
26137,Michigan,Otsego County,24247,50823,44.9,17049,2470,1274,7860,261,349,938,750,188,868,735,133,1108,882,226,1133,1025,108,21.96,7.761,4.44
26025,Michigan,Calhoun County,134327,46213,39.9,90848,12698,6364,37346,1015,2101,6226,4984,1242,5728,5232,496,6683,5347,1336,7523,6673,850,20.982,8.344,5.626
26031,Michigan,Cheboygan County,25475,42876,50.1,19222,2385,1361,9268,348,585,834,699,135,907,730,177,1003,702,301,925,844,81,19.488,10.067,6.312
26095,Michigan,Luce County,6406,41221,44.2,4805,495,230,1741,40,80,235,204,31,152,143,9,250,192,58,231,177,54,15.088,6.893,4.595
26081,Michigan,Kent County,636376,57302,35,415501,94426,49731,163289,4350,7033,32377,27285,5092,32631,29337,3294,42460,34989,7471,43002,38377,4625,34.695,6.971,4.307
26099,Michigan,Macomb County,864019,58175,41,603335,95834,50309,248844,7863,15731,37906,32224,5682,37014,32560,4454,47231,38990,8241,48620,42756,5864,24.223,9.481,6.322
26145,Michigan,Saginaw County,193803,45034,40.8,131855,18221,9625,56305,1382,3325,9060,7873,1187,9791,8862,929,9858,7661,2197,9889,8718,1171,21.119,8.36,5.905
26155,Michigan,Shiawassee County,68617,50967,42,47636,5027,2708,20898,584,949,3021,2514,507,2750,2318,432,3347,2920,427,3398,3118,280,16.238,7.336,4.541
26013,Michigan,Baraga County,8580,42757,43.4,6246,613,353,2507,97,129,182,168,14,208,192,16,212,173,39,239,213,26,15.466,9.015,5.146
26017,Michigan,Bay County,105350,45983,42.9,74771,9685,4521,34431,1036,1840,4458,3944,514,4493,4092,401,5600,4388,1212,5312,4674,638,18.999,8.353,5.344
26029,Michigan,Charlevoix County,26160,51567,47.7,19123,3346,2446,9112,342,633,859,718,141,897,812,85,1165,922,243,1081,878,203,30.288,10.7,6.947
26045,Michigan,Eaton County,108586,59244,40.9,75426,12750,6949,31395,780,1615,4893,4190,703,4730,4085,645,5927,5069,858,5949,5429,520,26.117,7.629,5.144
26041,Michigan,Delta County,36395,44639,46.9,26442,3760,1722,12714,278,717,1314,997,317,1345,1186,159,1593,1339,254,1498,1283,215,20.732,7.826,5.639
26053,Michigan,Gogebic County,15577,36689,48.7,11823,1434,739,5138,123,240,684,482,202,458,326,132,508,358,150,602,537,65,18.379,7.065,4.671
26047,Michigan,Emmet County,32978,51475,45,23755,4826,2980,10648,397,719,1286,956,330,1101,916,185,1568,1202,366,1681,1533,148,32.86,10.481,6.752
26033,Michigan,Chippewa County,38023,44030,39.7,26147,3597,1816,9801,337,519,2004,1679,325,2053,1808,245,1903,1502,401,1599,1326,273,20.702,8.734,5.295
26115,Michigan,Monroe County,149619,59479,42.2,104005,12881,6422,47019,1321,2721,6326,5455,871,5975,5391,584,7343,6370,973,7400,6637,763,18.56,8.597,5.787
26005,Michigan,Allegan County,114145,58487,39.7,76740,11470,5622,34873,909,1876,4787,4058,729,4393,3856,537,5830,5060,770,5780,5397,383,22.273,7.986,5.38
26125,Michigan,Oakland County,1241860,73369,41,868144,225174,171886,352687,10652,21960,53737,47044,6693,49911,44706,5205,68798,59263,9535,69665,63017,6648,45.737,9.247,6.226
26059,Michigan,Hillsdale County,45909,46160,42,31231,3320,1919,13684,451,742,1971,1747,224,2142,1960,182,2226,1699,527,2034,1689,345,16.775,8.718,5.422
26003,Michigan,Alger County,9254,42647,49.3,7131,868,398,2809,128,143,206,149,57,222,180,42,377,271,106,268,186,82,17.753,9.648,5.091
26121,Michigan,Muskegon County,172707,46077,39.1,116760,14978,6729,48466,1318,2472,7530,6304,1226,7543,6649,894,9120,7306,1814,9407,8310,1097,18.591,7.82,5.1
26127,Michigan,Oceana County,26317,44382,42.7,18002,2099,1167,8206,208,518,1141,830,311,899,750,149,1216,888,328,1185,1014,171,18.142,8.847,6.312
26089,Michigan,Leelanau County,21564,62646,53.3,16453,3923,2785,7843,285,687,762,677,85,693,616,77,826,631,195,785,669,116,40.771,12.393,8.759
26087,Michigan,Lapeer County,88205,56186,43.6,61608,7313,4032,27348,994,2099,3574,3133,441,3190,2910,280,4063,3332,731,3796,3279,517,18.415,11.31,7.675
26035,Michigan,Clare County,30597,35913,46.9,22312,1707,999,10371,471,870,1022,694,328,1043,886,157,1364,990,374,1472,1210,262,12.128,12.93,8.389
26151,Michigan,Sanilac County,41535,44417,44.8,29233,2514,1551,13676,394,860,1544,1192,352,1434,1164,270,1851,1328,523,1840,1504,336,13.906,9.169,6.288
26083,Michigan,Keweenaw County,2136,41118,55.1,1651,251,164,872,26,37,60,33,27,52,35,17,63,51,12,54,54,0,25.136,7.225,4.243
26073,Michigan,Isabella County,70572,42771,27.4,37896,6436,4718,15307,435,906,8560,7668,892,9674,8711,963,3951,3093,858,3546,3018,528,29.433,8.761,5.919
26131,Michigan,Ontonagon County,6072,36073,57.1,5010,615,255,2598,103,162,140,113,27,129,80,49,153,121,32,169,143,26,17.365,10.2,6.236
26139,Michigan,Ottawa County,280243,63962,34.9,172590,37735,18372,77206,1964,3237,17439,15389,2050,17905,16937,968,14663,12689,1974,14712,13833,879,32.509,6.737,4.193
26157,Michigan,Tuscola County,53569,45495,44.1,37932,3532,1697,17727,586,1151,2190,1839,351,1977,1639,338,2554,2148,406,2456,2269,187,13.785,9.799,6.493
26001,Michigan,Alcona County,10413,39424,57.9,8510,847,444,4391,107,280,259,189,70,250,207,43,269,159,110,291,250,41,15.17,8.813,6.377
26007,Michigan,Alpena County,28730,40954,47.6,21105,2347,1304,9851,204,607,1086,935,151,1030,885,145,1322,1087,235,1293,1149,144,17.299,8.233,6.162
26067,Michigan,Ionia County,64147,51980,38.7,43193,4981,2004,17634,417,1013,2943,2430,513,2451,2222,229,3157,2704,453,3122,2835,287,16.172,8.109,5.745
26079,Michigan,Kalkaska County,17358,43431,44.6,12481,969,592,5652,157,407,601,495,106,509,425,84,904,735,169,829,707,122,12.507,9.979,7.201
26111,Michigan,Midland County,83489,57117,41.5,57788,11924,7760,25791,573,1037,3801,3196,605,3338,3012,326,4614,4091,523,4296,3982,314,34.062,6.242,4.021
27167,Minnesota,Wilkin County,6398,52917,44.3,4496,758,175,2168,63,67,192,159,33,178,178,0,335,291,44,295,286,9,20.752,5.996,3.09
27125,Minnesota,Red Lake County,4017,52500,42.2,2778,348,112,1409,44,27,137,116,21,97,73,24,184,164,20,195,194,1,16.559,5.039,1.916
27001,Minnesota,Aitkin County,15841,45860,54.5,12338,1446,613,6364,284,501,417,374,43,400,373,27,496,447,49,520,504,16,16.688,12.335,7.872
27027,Minnesota,Clay County,62040,61409,32.6,37462,8955,3495,16114,418,672,4403,3934,469,4902,4657,245,4054,3557,497,3709,3483,226,33.234,6.764,4.17
27043,Minnesota,Faribault County,13966,50847,46.8,10037,1320,419,4743,102,203,395,323,72,417,381,36,655,580,75,638,535,103,17.326,6.431,4.28
27101,Minnesota,Murray County,8394,54211,48.1,6070,778,322,3020,76,121,283,238,45,270,250,20,345,294,51,315,301,14,18.122,6.523,4.007
27045,Minnesota,Fillmore County,20825,57093,42.5,14335,2100,870,6873,227,363,739,596,143,657,506,151,1004,765,239,982,851,131,20.719,8.584,5.282
27067,Minnesota,Kandiyohi County,42577,56604,39.5,28672,4382,2099,12381,516,630,1811,1440,371,1710,1598,112,2675,2282,393,2298,2103,195,22.604,9.256,5.088
27075,Minnesota,Lake County,10578,56078,50.3,8020,1484,840,4259,107,211,275,271,4,285,240,45,475,443,32,408,368,40,28.978,7.467,4.954
27119,Minnesota,Polk County,31564,55393,38.7,21131,3622,1559,9243,172,376,1443,1364,79,1331,1231,100,1809,1581,228,1558,1395,163,24.518,5.929,4.068
27133,Minnesota,Rock County,9433,56753,40.9,6400,1005,391,2967,66,161,297,284,13,266,231,35,473,433,40,476,402,74,21.813,7.651,5.426
27135,Minnesota,Roseau County,15537,56273,41.4,10460,1524,483,4817,87,162,624,579,45,558,539,19,767,629,138,652,626,26,19.187,5.169,3.363
27143,Minnesota,Sibley County,14888,60848,41.6,10212,1271,425,4688,119,263,523,495,28,507,458,49,739,641,98,662,612,50,16.608,8.148,5.61
27155,Minnesota,Traverse County,3357,48889,48.6,2422,319,107,1267,15,86,140,136,4,115,107,8,130,125,5,140,138,2,17.589,7.972,6.788
27165,Minnesota,Watonwan County,10936,50044,39.9,7335,860,258,3181,54,118,498,328,170,360,284,76,588,379,209,530,422,108,15.242,5.407,3.71
27005,Minnesota,Becker County,33552,55884,41.8,22920,3880,1632,10538,431,618,1154,892,262,1165,1045,120,1586,1295,291,1648,1488,160,24.049,9.954,5.864
27053,Minnesota,Hennepin County,1224763,71154,36.3,845407,259301,148014,311517,10165,20119,55836,49293,6543,56845,52091,4754,95130,83288,11842,92970,85418,7552,48.18,9.721,6.458
27011,Minnesota,Big Stone County,5039,48299,49,3672,465,152,1747,40,72,173,154,19,170,147,23,245,216,29,208,175,33,16.803,6.411,4.121
27015,Minnesota,Brown County,25243,55764,42.5,17285,2522,904,8304,123,277,1079,969,110,980,925,55,1367,1272,95,1331,1237,94,19.821,4.817,3.336
27023,Minnesota,Chippewa County,12040,57601,43,8288,1126,350,3526,83,149,495,285,210,417,362,55,593,530,63,638,589,49,17.809,6.58,4.226
27021,Minnesota,Cass County,28810,50162,48.7,20878,3148,1372,10464,336,751,853,688,165,852,782,70,1154,936,218,1237,1130,107,21.65,10.388,7.177
27029,Minnesota,Clearwater County,8824,45638,42.7,6033,679,243,2727,80,170,288,218,70,284,242,42,429,315,114,379,335,44,15.283,9.168,6.234
27049,Minnesota,Goodhue County,46138,62431,42.9,32295,5524,2454,14435,449,715,1752,1568,184,1562,1365,197,2264,1952,312,2383,2116,267,24.704,8.064,4.953
27057,Minnesota,Hubbard County,20743,52941,48.6,15095,2717,1305,7212,209,514,664,463,201,560,494,66,860,719,141,812,720,92,26.645,10.025,7.127
27059,Minnesota,Isanti County,38584,67565,39.5,26236,3168,1360,11889,446,858,1572,1451,121,1302,1235,67,2250,1971,279,2217,2080,137,17.259,10.968,7.217
27063,Minnesota,Jackson County,10104,55122,44,7103,1068,367,3426,99,86,355,314,41,331,327,4,535,483,52,504,485,19,20.203,5.4,2.51
27091,Minnesota,Martin County,20084,53627,45.2,14218,2131,714,6478,129,265,706,564,142,773,676,97,960,860,100,974,817,157,20.01,6.082,4.091
27099,Minnesota,Mower County,39386,53700,39.3,26563,3719,1777,11374,301,498,1606,1156,450,1375,1147,228,2206,1929,277,2156,1918,238,20.69,7.025,4.378
27105,Minnesota,Nobles County,21854,53267,36,13980,1401,623,5632,165,230,1112,726,386,1000,877,123,1408,1161,247,972,802,170,14.478,7.013,4.084
27115,Minnesota,Pine County,29057,47285,44.5,21042,2016,901,8434,303,713,1058,908,150,1007,909,98,1325,1051,274,1209,1057,152,13.863,12.046,8.454
27109,Minnesota,Olmsted County,151685,72337,37.1,102459,25018,19105,44164,938,1777,5739,4793,946,6062,5691,371,9937,8876,1061,10379,9875,504,43.064,6.148,4.024
27033,Minnesota,Cottonwood County,11437,50524,43.3,7888,1212,401,3743,48,178,378,301,77,407,386,21,530,427,103,538,512,26,20.449,6.038,4.756
27139,Minnesota,Scott County,141463,93151,36,90423,25366,9845,39719,1348,2124,5192,4512,680,4870,4620,250,7785,6871,914,7985,7460,525,38.94,8.741,5.348
27039,Minnesota,Dodge County,20485,71078,38,13372,2427,863,6342,179,217,706,622,84,728,687,41,1108,968,140,1041,924,117,24.604,6.244,3.422
27157,Minnesota,Wabasha County,21490,61973,45,15298,2264,1048,7177,165,364,697,578,119,714,690,24,1032,919,113,986,937,49,21.65,7.371,5.072
27117,Minnesota,Pipestone County,9229,48909,42.4,6282,985,300,3009,44,178,306,252,54,316,287,29,445,367,78,491,443,48,20.455,7.378,5.916
27035,Minnesota,Crow Wing County,63505,53121,44.1,44990,7129,3932,19920,604,1482,2373,2024,349,2142,1920,222,3061,2612,449,3151,2817,334,24.585,10.472,7.44
27107,Minnesota,Norman County,6589,53034,44.3,4568,637,163,2212,41,48,227,186,41,236,216,20,271,211,60,236,218,18,17.513,4.024,2.17
27171,Minnesota,Wright County,131130,77953,36.2,84112,17100,5985,38387,1266,2266,4725,4370,355,4899,4701,198,7190,6446,744,7316,6887,429,27.446,9.201,5.903
27103,Minnesota,Nicollet County,33477,62593,36.3,21820,4683,2352,9218,321,439,1790,1644,146,2044,2029,15,2191,1994,197,1879,1783,96,32.241,8.245,4.762
27041,Minnesota,Douglas County,36891,58667,44.3,26304,4682,1938,12149,383,656,1392,1296,96,1222,1185,37,2068,1936,132,1919,1824,95,25.167,8.552,5.4
27051,Minnesota,Grant County,5923,53727,45.3,4217,595,190,2011,53,91,179,164,15,202,168,34,291,276,15,288,280,8,18.615,7.161,4.525
27069,Minnesota,Kittson County,4384,52304,47.9,3127,540,186,1520,22,7,165,134,31,133,98,35,184,165,19,151,137,14,23.217,1.908,0.461
27079,Minnesota,Le Sueur County,27810,65500,41.4,18996,3103,1061,8878,224,493,1018,944,74,1007,944,63,1413,1291,122,1315,1173,142,21.92,8.076,5.553
27087,Minnesota,Mahnomen County,5500,42439,35.7,3351,285,121,1355,28,60,235,194,41,204,141,63,223,147,76,260,212,48,12.116,6.494,4.428
27025,Minnesota,Chisago County,54297,76747,40.9,37394,5690,2231,16975,686,1023,2050,1857,193,1786,1677,109,2825,2436,389,2638,2448,190,21.183,10.068,6.027
27127,Minnesota,Redwood County,15430,51871,43.5,10539,1511,432,4871,85,157,637,556,81,485,443,42,688,618,70,702,600,102,18.436,4.968,3.223
27173,Minnesota,Yellow Medicine County,9930,54645,42.6,6924,819,273,3238,68,148,357,303,54,345,322,23,573,495,78,506,453,53,15.771,6.671,4.571
27153,Minnesota,Todd County,24423,49213,43.7,16745,1836,600,7996,265,471,966,778,188,751,632,119,1052,859,193,1060,917,143,14.548,9.205,5.89
27007,Minnesota,Beltrami County,45847,45923,33.4,27843,4780,2730,11648,333,718,3122,2688,434,2990,2534,456,2669,2046,623,2459,2104,355,26.973,9.023,6.164
27013,Minnesota,Blue Earth County,65767,53752,30.6,38058,8101,4160,15848,496,751,6996,6477,519,6827,6619,208,4223,3689,534,3646,3410,236,32.217,7.869,4.739
27055,Minnesota,Houston County,18709,56837,45.4,13332,2196,893,6514,181,321,677,577,100,670,640,30,868,773,95,817,768,49,23.17,7.706,4.928
27073,Minnesota,Lac qui Parle County,6840,50195,50,5022,695,257,2552,75,88,191,172,19,243,234,9,265,234,31,231,219,12,18.957,6.387,3.448
27077,Minnesota,Lake of the Woods County,3841,46943,51.1,2839,390,92,1251,25,91,159,147,12,116,110,6,118,111,7,119,119,0,16.978,9.273,7.274
27111,Minnesota,Otter Tail County,57790,55181,46.6,41088,7105,3048,19152,546,1031,2111,1863,248,1885,1785,100,2529,2116,413,2404,2139,265,24.71,8.234,5.383
27161,Minnesota,Waseca County,18898,55189,39.6,12994,1875,747,5738,197,265,718,657,61,655,605,50,969,853,116,976,889,87,20.179,8.052,4.618
27137,Minnesota,St. Louis County,200294,50936,41,136240,25965,12710,60738,1709,3073,12682,11586,1096,11882,11293,589,10719,9478,1241,9712,9137,575,28.387,7.873,5.059
27003,Minnesota,Anoka County,344861,76796,38.2,233378,47125,19870,100959,3070,4810,14269,12839,1430,12955,12079,876,20356,18222,2134,20635,19181,1454,28.707,7.805,4.764
27145,Minnesota,Stearns County,155300,59564,34.1,95525,17703,8247,40293,1140,1888,11760,10765,995,11246,10591,655,8909,7819,1090,8063,7629,434,27.166,7.515,4.686
27037,Minnesota,Dakota County,414655,79995,37.7,278415,78605,35731,118058,3831,6153,17147,15107,2040,15512,14378,1134,24356,21926,2430,25416,23710,1706,41.067,8.457,5.212
27081,Minnesota,Lincoln County,5724,51102,45.9,4048,666,131,1959,51,69,171,157,14,173,158,15,248,203,45,232,201,31,19.689,6.126,3.522
27083,Minnesota,Lyon County,25789,54181,35.6,16561,3231,1154,6862,203,254,1415,1336,79,1389,1311,78,1516,1319,197,1517,1417,100,26.478,6.66,3.702
27089,Minnesota,Marshall County,9397,57289,43.4,6550,1004,313,3204,77,78,387,316,71,300,287,13,455,403,52,426,390,36,20.107,4.838,2.434
27095,Minnesota,Mille Lacs County,25635,53737,40.1,17541,1887,830,7474,380,502,863,760,103,970,861,109,1395,1220,175,1292,1173,119,15.489,11.801,6.717
27129,Minnesota,Renville County,14798,56721,44.4,10362,1165,340,4944,88,164,526,465,61,443,394,49,753,635,118,644,580,64,14.524,5.097,3.317
27163,Minnesota,Washington County,250979,89598,39.2,168235,46409,24767,74764,2219,3933,9473,8602,871,9064,8529,535,12799,11821,978,13560,13079,481,42.307,8.229,5.261
27017,Minnesota,Carlton County,35408,58874,40.7,24634,3896,1399,10687,372,590,1375,1213,162,1131,1011,120,1965,1744,221,1730,1623,107,21.495,9.002,5.521
27031,Minnesota,Cook County,5270,51903,52.1,4194,1059,636,2025,73,191,165,135,30,130,107,23,224,177,47,304,251,53,40.415,13.037,9.432
27065,Minnesota,Kanabec County,15948,50509,44.5,11293,1086,581,5177,188,391,587,503,84,536,513,23,797,674,123,695,604,91,14.761,11.184,7.553
27071,Minnesota,Koochiching County,12776,47131,48.6,9417,1218,540,4429,147,205,447,359,88,423,384,39,562,503,59,533,525,8,18.668,7.948,4.629
27093,Minnesota,Meeker County,23105,59611,42.2,15812,2180,838,7211,183,319,784,712,72,760,708,52,1108,986,122,983,902,81,19.087,6.962,4.424
27097,Minnesota,Morrison County,32880,52855,41.7,22747,2681,1051,10571,364,596,1211,1008,203,1072,1019,53,1751,1571,180,1685,1551,134,16.407,9.081,5.638
27113,Minnesota,Pennington County,14197,53893,39.5,9743,1423,396,4330,43,204,665,644,21,577,562,15,851,783,68,804,795,9,18.67,5.704,4.711
27131,Minnesota,Rice County,65251,63311,36.6,41228,6864,4165,17012,572,988,4359,4164,195,4229,4082,147,3179,2722,457,2973,2640,333,26.751,9.17,5.808
27147,Minnesota,Steele County,36612,58882,39.3,24475,4275,1745,11050,292,533,1471,1391,80,1193,1110,83,2027,1750,277,1976,1880,96,24.597,7.466,4.824
27141,Minnesota,Sherburne County,92024,83895,35.9,59289,11807,4458,25920,1031,1196,4194,3850,344,3466,3367,99,5052,4700,352,5188,4986,202,27.433,8.592,4.614
27159,Minnesota,Wadena County,13626,45018,41.7,9250,819,374,4427,168,251,517,404,113,479,456,23,639,547,92,583,546,37,12.897,9.465,5.67
27009,Minnesota,Benton County,39360,53574,35.6,26307,4289,1537,10998,340,752,1611,1367,244,1638,1475,163,3001,2656,345,2837,2686,151,22.146,9.929,6.838
27019,Minnesota,Carver County,98799,93095,37.2,63685,21349,8870,28695,645,1597,3590,3377,213,3585,3462,123,4976,4692,284,5022,4706,316,47.451,7.813,5.565
27047,Minnesota,Freeborn County,30619,51174,44.3,21872,2652,1027,9958,203,473,1057,843,214,1031,888,143,1600,1273,327,1562,1422,140,16.821,6.789,4.75
27061,Minnesota,Itasca County,45237,52050,45.9,32507,5025,2342,15559,631,818,1523,1245,278,1365,1174,191,2042,1726,316,2011,1804,207,22.663,9.313,5.257
27085,Minnesota,McLeod County,35816,59869,40.4,24719,3161,1295,11558,527,520,1350,1186,164,1297,1197,100,2038,1842,196,1934,1847,87,18.027,9.059,4.499
27121,Minnesota,Pope County,10932,58198,45.9,7915,1243,512,3881,121,180,334,297,37,302,282,20,614,552,62,535,518,17,22.173,7.756,4.638
27123,Minnesota,Ramsey County,537893,60301,34.8,355855,88453,59277,123722,4306,7042,27864,23743,4121,29632,26934,2698,38854,33324,5530,39495,35606,3889,41.514,9.172,5.692
27149,Minnesota,Stevens County,9759,57552,33.1,5755,1219,440,2413,58,45,738,701,37,896,864,32,568,551,17,438,433,5,28.827,4.269,1.865
27151,Minnesota,Swift County,9448,49556,44.1,6660,885,250,2917,58,53,316,261,55,296,266,30,514,444,70,496,466,30,17.042,3.805,1.817
27169,Minnesota,Winona County,50992,53975,34.5,31225,6034,3196,13462,357,680,4623,4207,416,4882,4516,366,2720,2277,443,2493,2237,256,29.56,7.703,5.051
28045,Mississippi,Hancock County,46277,47518,43.2,32556,4420,2385,14076,338,1103,1741,1140,601,1832,1361,471,2254,1469,785,2334,1396,938,20.902,10.237,7.836
28125,Mississippi,Sharkey County,4631,30033,39.6,3138,486,188,1124,61,48,163,62,101,146,109,37,241,201,40,255,180,75,21.479,9.698,4.27
28139,Mississippi,Tippah County,21993,39351,38.6,14372,1450,631,6080,203,385,1128,816,312,1045,896,149,890,717,173,1018,828,190,14.48,9.671,6.332
28019,Mississippi,Choctaw County,8360,34542,44.3,5795,649,356,2446,53,155,236,171,65,366,333,33,396,317,79,343,315,28,17.343,8.504,6.337
28035,Mississippi,Forrest County,75835,39555,32,46579,7286,5168,15459,305,853,5455,3811,1644,6473,4949,1524,4571,3089,1482,4953,4049,904,26.737,7.491,5.518
28057,Mississippi,Itawamba County,23439,38358,39.8,15658,1275,753,6637,279,190,1288,998,290,1189,976,213,1204,871,333,1194,943,251,12.952,7.066,2.863
28071,Mississippi,Lafayette County,52744,45019,29.3,30059,6814,5766,11551,316,553,6360,5522,838,6087,5496,591,3047,2054,993,3171,2626,545,41.851,7.523,4.787
28055,Mississippi,Issaquena County,1296,25609,38.8,1029,25,38,201,3,11,9,0,9,37,37,0,104,95,9,88,78,10,6.122,6.965,5.473
28059,Mississippi,Jackson County,141314,50274,38.3,95361,12245,7491,35803,1037,1891,5930,4377,1553,5815,3776,2039,7628,4987,2641,8267,5924,2343,20.696,8.178,5.282
28087,Mississippi,Lowndes County,59558,43198,36.6,39223,5836,3426,13872,445,803,2412,1659,753,2911,2224,687,3216,2259,957,3797,2776,1021,23.614,8.997,5.789
28083,Mississippi,Leflore County,30113,25210,33.1,18120,2069,1179,5145,209,254,1533,807,726,1703,1248,455,1563,1092,471,1869,1287,582,17.925,8.999,4.937
28143,Mississippi,Tunica County,10276,32052,32.9,6668,768,375,1494,13,163,351,277,74,441,206,235,585,416,169,821,618,203,17.142,11.78,10.91
28157,Mississippi,Wilkinson County,9084,23340,37.3,6308,585,357,2326,44,168,293,120,173,310,226,84,495,253,242,469,403,66,14.933,9.114,7.223
28021,Mississippi,Claiborne County,9106,24601,33.8,5312,527,471,2190,35,97,789,475,314,853,710,143,371,212,159,443,321,122,18.788,6.027,4.429
28047,Mississippi,Harrison County,200491,44684,35.9,131512,18557,10596,43284,1517,3103,8736,5582,3154,8736,6064,2672,10899,6934,3965,12910,9356,3554,22.168,10.674,7.169
28065,Mississippi,Jefferson Davis County,11639,26736,43.6,8118,792,423,3592,85,414,456,255,201,535,418,117,463,282,181,610,461,149,14.967,13.892,11.526
28127,Mississippi,Simpson County,27215,37591,38.9,18162,1551,858,7360,328,469,1226,824,402,1094,802,292,1425,923,502,1544,1034,510,13.264,10.829,6.372
28075,Mississippi,Lauderdale County,78221,41340,37.7,52004,6551,3913,19611,469,976,3452,2247,1205,3517,2412,1105,3815,2611,1204,4511,3331,1180,20.122,7.368,4.977
28085,Mississippi,Lincoln County,34542,37308,37.8,23045,2166,1283,9591,182,437,1432,1008,424,1415,1114,301,1687,1152,535,2009,1416,593,14.966,6.454,4.556
28123,Mississippi,Scott County,28399,33601,36.5,18442,1600,735,7177,201,293,1381,918,463,1144,747,397,1641,1033,608,1722,1196,526,12.661,6.883,4.082
28159,Mississippi,Winston County,18482,33313,42,12800,1351,680,5341,170,332,722,510,212,781,459,322,829,513,316,972,731,241,15.867,9.399,6.216
28163,Mississippi,Yazoo County,27496,28330,35.7,18217,1597,1007,5353,169,327,1303,619,684,1205,869,336,1269,922,347,1393,1143,250,14.294,9.266,6.109
28007,Mississippi,Attala County,18731,33815,39.9,12426,1021,513,5061,168,156,827,515,312,716,547,169,764,484,280,1017,839,178,12.345,6.402,3.082
28009,Mississippi,Benton County,8306,40605,42,5669,355,228,2449,64,101,525,395,130,255,158,97,312,226,86,458,247,211,10.284,6.737,4.124
28037,Mississippi,Franklin County,7772,42388,42.5,5417,594,283,2370,30,77,168,101,67,291,211,80,496,407,89,383,289,94,16.19,4.515,3.249
28027,Mississippi,Coahoma County,24296,28728,34,14895,1719,805,4596,149,154,1210,663,547,1244,983,261,1152,823,329,1562,1290,272,16.945,6.593,3.351
28061,Mississippi,Jasper County,16547,35271,40.8,11241,1013,555,5736,68,347,665,403,262,742,521,221,842,581,261,768,601,167,13.949,7.235,6.05
28067,Mississippi,Jones County,68328,38656,37.1,44791,4580,3671,17904,732,747,2929,2386,543,2704,2062,642,3778,2826,952,4298,2963,1335,18.421,8.261,4.172
28147,Mississippi,Walthall County,14670,31077,40.3,9696,555,445,5280,108,494,785,389,396,565,310,255,444,185,259,604,370,234,10.314,11.402,9.356
28095,Mississippi,Monroe County,35967,39444,41,24708,3025,1040,10522,164,542,1456,1085,371,1429,950,479,1555,1134,421,2018,1587,431,16.452,6.71,5.151
28115,Mississippi,Pontotoc County,31075,41865,36.8,20055,2107,873,7855,149,401,1428,867,561,1437,935,502,1567,1201,366,1655,1307,348,14.859,7.002,5.105
28133,Mississippi,Sunflower County,26915,28556,34.9,17666,1710,850,4784,182,430,1424,810,614,1470,901,569,1277,890,387,1298,988,310,14.491,12.793,8.988
28155,Mississippi,Webster County,9868,35634,39.9,6711,804,414,2863,44,182,344,210,134,319,240,79,517,356,161,567,500,67,18.149,7.894,6.357
28003,Mississippi,Alcorn County,37242,38919,40.1,25228,2282,1738,10303,163,469,1817,1166,651,1564,954,610,1818,1247,571,1929,1594,335,15.935,6.134,4.552
28001,Mississippi,Adams County,31583,30359,40.3,21829,2327,1471,7189,238,377,1005,578,427,1261,1024,237,1482,608,874,1575,1248,327,17.399,8.555,5.244
28025,Mississippi,Clay County,19990,34118,39.4,13424,1658,938,5514,234,329,952,701,251,897,752,145,930,656,274,1155,825,330,19.338,10.21,5.967
28033,Mississippi,DeSoto County,173267,62595,36.6,112357,17987,8387,44744,1276,2898,7389,5663,1726,7324,6209,1115,9440,7154,2286,10260,8708,1552,23.473,9.329,6.477
28031,Mississippi,Covington County,19172,36471,37.5,12596,1171,858,5651,225,293,862,640,222,924,617,307,878,458,420,1149,796,353,16.108,9.167,5.185
28053,Mississippi,Humphreys County,8678,26188,36.4,5532,425,328,1815,54,198,402,198,204,406,289,117,459,273,186,492,395,97,13.612,13.884,10.909
28013,Mississippi,Calhoun County,14617,33370,40.5,9908,579,534,4167,83,126,498,304,194,548,418,130,744,498,246,773,536,237,11.233,5.016,3.024
28051,Mississippi,Holmes County,18267,20330,34.5,11161,762,433,3828,155,309,1240,737,503,964,571,393,837,385,452,988,685,303,10.707,12.121,8.072
28005,Mississippi,Amite County,12574,30129,46.4,9304,796,435,4287,83,238,277,178,99,466,310,156,715,461,254,662,525,137,13.231,7.488,5.552
28089,Mississippi,Madison County,102212,68600,37,67127,18123,13080,27134,681,1707,4374,3602,772,4855,4075,780,5432,4536,896,6271,5228,1043,46.484,8.801,6.291
28091,Mississippi,Marion County,25466,30998,39.9,17197,1512,711,7601,120,417,1024,438,586,1052,529,523,1316,1010,306,1379,1075,304,12.927,7.065,5.486
28141,Mississippi,Tishomingo County,19476,36672,42.6,13621,1054,514,5771,128,193,723,592,131,831,549,282,895,660,235,924,639,285,11.512,5.562,3.344
28153,Mississippi,Wayne County,20458,35215,37.4,13643,880,839,6275,86,370,825,627,198,925,829,96,1242,787,455,1145,1023,122,12.6,7.267,5.896
28041,Mississippi,Greene County,13801,48029,39,9920,610,253,3655,60,117,367,244,123,566,442,124,527,388,139,524,398,126,8.7,4.843,3.201
28093,Mississippi,Marshall County,35981,41134,39.9,24467,2395,822,9928,318,763,1548,820,728,1958,1329,629,1727,1139,588,1725,1277,448,13.148,10.888,7.685
28119,Mississippi,Quitman County,7537,25671,37.9,4999,369,220,2013,49,136,295,91,204,342,219,123,341,243,98,406,260,146,11.782,9.19,6.756
28011,Mississippi,Bolivar County,33121,28468,35,21136,2986,1860,6800,167,476,1877,1222,655,1958,1448,510,1755,1139,616,2059,1551,508,22.928,9.456,7
28073,Mississippi,Lamar County,60517,56129,34.7,39297,8917,5204,15007,480,585,2840,1928,912,2986,2488,498,3772,2786,986,4520,3736,784,35.934,7.097,3.898
28081,Mississippi,Lee County,84840,45985,37,55803,8312,4784,21853,715,1236,3478,2322,1156,3762,2826,936,4793,3403,1390,5307,4270,1037,23.468,8.928,5.656
28113,Mississippi,Pike County,39763,30949,37,25292,2563,1471,10232,178,800,1812,1286,526,1803,1412,391,1779,1102,677,2149,1581,568,15.95,9.558,7.819
28135,Mississippi,Tallahatchie County,14552,30000,34.7,10390,734,315,3323,77,216,456,314,142,577,478,99,405,364,41,689,556,133,10.096,8.817,6.5
28129,Mississippi,Smith County,16114,37697,40.1,10803,774,418,4738,22,175,615,416,199,676,430,246,669,525,144,804,642,162,11.034,4.158,3.694
28131,Mississippi,Stone County,17981,46283,37.4,11685,1307,442,4690,31,378,973,606,367,1044,831,213,741,529,212,866,730,136,14.968,8.721,8.06
28149,Mississippi,Warren County,47510,41635,38.2,31711,4219,3031,11817,452,964,1982,1195,787,2224,1420,804,2420,1772,648,2721,2252,469,22.863,11.983,8.158
28023,Mississippi,Clarke County,16089,37626,41.8,11108,993,481,5284,77,295,607,518,89,700,482,218,764,676,88,844,730,114,13.27,7.04,5.583
28069,Mississippi,Kemper County,10082,27016,41.7,6914,575,331,2824,63,179,439,256,183,488,223,265,498,427,71,421,350,71,13.104,8.569,6.339
28097,Mississippi,Montgomery County,10309,34983,42.6,7130,1049,446,3350,44,128,387,319,68,468,339,129,473,384,89,483,415,68,20.968,5.134,3.821
28105,Mississippi,Oktibbeha County,49392,37348,25.4,25070,5044,5632,9256,107,621,7982,6953,1029,6564,5909,655,3076,2315,761,2906,2561,345,42.585,7.865,6.709
28099,Mississippi,Neshoba County,29437,36755,36.7,18610,1782,833,7917,300,273,1051,594,457,1218,804,414,1445,894,551,1649,1406,243,14.052,7.238,3.448
28109,Mississippi,Pearl River County,55049,44734,41,37230,3954,1614,15858,505,957,2381,1827,554,2420,1880,540,2573,1782,791,2711,1927,784,14.956,9.219,6.035
28079,Mississippi,Leake County,22936,35578,35.8,14612,1191,584,5922,189,355,1021,888,133,990,660,330,1171,821,350,1227,886,341,12.148,9.186,5.995
28103,Mississippi,Noxubee County,10942,30808,36,7161,589,333,2960,26,220,461,230,231,493,390,103,679,505,174,611,533,78,12.875,8.311,7.432
28121,Mississippi,Rankin County,149645,61605,37.2,101973,19423,10325,41552,1202,1651,5682,4482,1200,5671,4610,1061,8487,7148,1339,9959,8654,1305,29.172,6.866,3.973
28137,Mississippi,Tate County,28333,46233,37.7,18395,1922,1041,7632,235,551,1340,997,343,1328,1131,197,1410,863,547,1429,1115,314,16.108,10.299,7.22
28151,Mississippi,Washington County,48002,29387,36.7,30707,3578,2252,9945,286,695,2248,1327,921,2278,1578,700,2481,1461,1020,2802,1868,934,18.986,9.864,6.988
28077,Mississippi,Lawrence County,12659,40432,40.4,8422,785,380,3817,65,165,581,392,189,450,257,193,571,410,161,672,489,183,13.833,6.026,4.323
28107,Mississippi,Panola County,34229,35891,37,22328,2188,1020,9061,160,427,1638,1048,590,1574,1198,376,1760,1175,585,1998,1434,564,14.368,6.478,4.713
28111,Mississippi,Perry County,12047,35374,40.7,8225,637,232,3672,52,175,491,314,177,549,484,65,599,348,251,608,485,123,10.565,6.182,4.766
28161,Mississippi,Yalobusha County,12426,37647,41.8,8539,757,437,3886,41,330,470,299,171,561,409,152,452,226,226,661,567,94,13.983,9.547,8.492
28017,Mississippi,Chickasaw County,17305,33579,37,11326,1009,324,4572,78,276,954,631,323,749,521,228,809,388,421,1017,785,232,11.769,7.743,6.037
28015,Mississippi,Carroll County,10221,43068,46,7140,789,382,2926,42,134,223,207,16,517,450,67,372,293,79,302,251,51,16.401,6.015,4.58
28029,Mississippi,Copiah County,28748,38046,38.2,18896,1806,706,7619,161,461,1673,1160,513,1373,935,438,1204,732,472,1645,1284,361,13.294,8.164,6.051
28039,Mississippi,George County,23545,47640,36.5,15216,1049,764,6155,153,266,1217,793,424,856,627,229,1240,845,395,1385,1023,362,11.915,6.807,4.322
28043,Mississippi,Grenada County,21379,34876,40.3,14325,1642,950,5392,124,706,746,495,251,1081,887,194,798,340,458,1121,645,476,18.094,15.393,13.093
28049,Mississippi,Hinds County,243249,41011,34.2,154349,25763,18367,52834,1630,4590,13295,8843,4452,14379,10681,3698,14301,10342,3959,16967,13635,3332,28.591,11.773,8.688
28063,Mississippi,Jefferson County,7463,21779,34.9,4951,244,386,1601,11,81,218,95,123,360,308,52,577,518,59,404,372,32,12.725,5.746,5.059
28101,Mississippi,Newton County,21437,37643,37.2,13659,1569,659,6219,55,340,1132,832,300,1119,904,215,910,625,285,1080,935,145,16.312,6.352,5.467
28145,Mississippi,Union County,28202,40076,37.9,18713,1606,1144,7172,292,421,1072,807,265,1339,932,407,1676,929,747,1353,1038,315,14.696,9.941,5.87
28117,Mississippi,Prentiss County,25389,32854,39.5,16919,1224,860,6755,254,419,1417,1137,280,1290,868,422,1164,817,347,1244,866,378,12.318,9.963,6.203
29091,Missouri,Howell County,40139,34984,40.2,27123,2359,1819,11208,345,838,1591,1136,455,1603,1192,411,2107,1607,500,2176,1710,466,15.404,10.555,7.477
29035,Missouri,Carter County,6255,37875,41.3,4245,345,179,1746,92,101,267,191,76,247,197,50,230,97,133,299,127,172,12.344,11.054,5.785
29057,Missouri,Dade County,7581,38880,46.7,5431,516,305,2444,46,169,283,226,57,258,191,67,291,145,146,276,165,111,15.117,8.797,6.915
29115,Missouri,Linn County,12248,41652,42.5,8403,816,428,3650,76,97,477,397,80,430,339,91,504,378,126,592,453,139,14.804,4.74,2.658
29101,Missouri,Johnson County,53941,50689,29.9,30916,5310,3465,11907,351,425,4416,3829,587,4870,4290,580,2944,2229,715,2916,2468,448,28.383,6.517,3.569
29105,Missouri,Laclede County,35488,42646,40.1,24088,2302,996,9350,397,428,1459,1008,451,1205,958,247,1771,1375,396,1965,1403,562,13.691,8.824,4.578
29125,Missouri,Maries County,8959,41715,44.4,6342,606,256,2678,99,169,392,316,76,228,166,62,357,308,49,402,310,92,13.592,10.007,6.311
29161,Missouri,Phelps County,44873,41681,34.8,27855,4569,3412,10547,315,494,4628,4338,290,2664,2287,377,2578,1979,599,2242,1801,441,28.652,7.67,4.684
29165,Missouri,Platte County,96899,74199,38.2,65703,16804,10463,24870,775,1188,4018,3566,452,3772,3169,603,5719,4733,986,5883,5101,782,41.5,7.893,4.777
29187,Missouri,St. Francois County,66248,42873,39.2,46373,3715,2434,16921,556,871,2586,1543,1043,2205,1756,449,3619,2740,879,3572,2861,711,13.26,8.433,5.147
29510,Missouri,St. Louis city,314867,38664,35.2,220141,41639,33469,60850,2052,5017,16326,12286,4040,18152,14945,3207,25934,20316,5618,28007,23232,4775,34.118,11.617,8.245
29003,Missouri,Andrew County,17358,56658,42.5,12033,1968,1058,5318,168,352,689,566,123,594,562,32,810,601,209,914,773,141,25.148,9.778,6.619
29023,Missouri,Butler County,42826,37878,40.3,29343,2899,1775,10479,187,629,1755,1071,684,1513,1101,412,2198,1571,627,2497,1875,622,15.929,7.787,6.002
29033,Missouri,Carroll County,8909,43583,42.8,6175,680,377,2663,76,73,299,266,33,337,273,64,403,258,145,419,333,86,17.117,5.595,2.741
29061,Missouri,Daviess County,8300,45707,41.3,5520,683,274,2426,65,122,289,158,131,305,188,117,328,218,110,379,262,117,17.337,7.708,5.029
29087,Missouri,Holt County,4499,43981,48.4,3355,525,204,1511,44,39,113,84,29,150,119,31,209,185,24,185,155,30,21.729,5.493,2.581
29103,Missouri,Knox County,3976,39674,43.7,2699,292,136,1265,37,61,199,125,74,95,71,24,165,114,51,175,115,60,15.858,7.747,4.822
29181,Missouri,Ripley County,13807,33849,42.5,9629,722,426,4143,122,167,525,296,229,539,432,107,681,447,234,666,439,227,11.922,6.976,4.031
29127,Missouri,Marion County,28703,44098,39.2,19324,2742,1291,7239,208,358,1241,1028,213,1365,1163,202,1470,1157,313,1572,1311,261,20.87,7.819,4.945
29139,Missouri,Montgomery County,11618,43094,43.9,8172,685,369,3495,72,257,347,232,115,332,276,56,572,460,112,570,486,84,12.898,9.413,7.353
29151,Missouri,Osage County,13610,54503,40.1,9216,1270,463,4217,69,80,775,630,145,491,412,79,700,594,106,661,607,54,18.804,3.533,1.897
29207,Missouri,Stoddard County,29634,40076,42.1,20643,1919,999,8158,297,299,1181,869,312,1316,944,372,1451,1065,386,1588,1225,363,14.136,7.306,3.665
29219,Missouri,Warren County,33554,56193,40.9,23096,2810,1500,9595,282,552,1190,990,200,1171,878,293,1708,1286,422,1902,1688,214,18.661,8.692,5.753
29221,Missouri,Washington County,24968,37810,40.6,17250,1003,537,7408,232,414,935,530,405,1017,732,285,1239,927,312,1219,832,387,8.928,8.72,5.589
29007,Missouri,Audrain County,25763,44056,39.6,17588,1520,897,6436,192,260,930,667,263,1108,785,323,1120,884,236,1147,918,229,13.742,7.023,4.04
29043,Missouri,Christian County,83028,55761,37.6,55146,10401,5012,22799,851,861,2845,2358,487,3281,2806,475,4669,3509,1160,5105,4547,558,27.949,7.509,3.776
29063,Missouri,DeKalb County,12564,46517,40.5,9411,1015,350,2562,58,83,255,192,63,302,224,78,513,454,59,470,369,101,14.504,5.504,3.24
29077,Missouri,Greene County,286759,43175,35.7,186539,35715,21098,69714,2481,3333,19470,14653,4817,20324,16740,3584,17852,13395,4457,17787,14732,3055,30.456,8.34,4.781
29081,Missouri,Harrison County,8615,42889,42.8,5915,600,259,2575,34,136,344,227,117,265,182,83,390,221,169,462,365,97,14.522,6.602,5.282
29107,Missouri,Lafayette County,32655,52557,42.2,22557,2755,1372,9644,221,512,1265,927,338,1259,1110,149,1681,1223,458,1615,1239,376,18.296,7.601,5.309
29185,Missouri,St. Clair County,9396,35066,50,6996,571,383,3111,69,274,304,181,123,248,160,88,426,277,149,328,241,87,13.636,11.025,8.807
29001,Missouri,Adair County,25437,38750,27.3,13426,2046,2120,5690,87,196,2909,2545,364,3790,3492,298,1182,945,237,1132,945,187,31.029,4.974,3.445
29197,Missouri,Schuyler County,4450,38848,40.6,2915,223,184,1208,24,19,169,103,66,136,100,36,198,99,99,188,140,48,13.962,3.56,1.573
29199,Missouri,Scotland County,4883,42939,37.2,3112,289,104,1336,39,113,212,52,160,203,97,106,247,129,118,236,146,90,12.629,11.377,8.458
29211,Missouri,Sullivan County,6382,42034,41.5,4433,276,197,1686,31,48,255,189,66,234,171,63,289,177,112,283,206,77,10.67,4.686,2.847
29029,Missouri,Camden County,44855,50496,51,33660,4870,2531,13034,395,834,1426,1139,287,1299,1009,290,1779,1218,561,1793,1430,363,21.988,9.429,6.399
29045,Missouri,Clark County,6807,45216,43.8,4736,430,196,2183,31,107,227,191,36,223,138,85,330,221,109,277,186,91,13.218,6.322,4.902
29097,Missouri,Jasper County,118522,45328,35.9,77228,12331,5187,29707,769,1450,5839,4228,1611,5820,4760,1060,7221,5091,2130,7415,5846,1569,22.683,7.47,4.881
29099,Missouri,Jefferson County,222639,60765,38.8,152103,19821,10251,66900,1957,3564,8643,7071,1572,8455,7119,1336,13054,10189,2865,12821,10458,2363,19.771,8.253,5.327
29111,Missouri,Lewis County,10078,47148,40.1,6546,528,413,2735,81,113,568,507,61,472,349,123,500,377,123,540,484,56,14.375,7.093,4.132
29119,Missouri,McDonald County,22753,41207,38.3,14918,1139,763,5753,212,359,1053,632,421,853,511,342,1153,737,416,1155,786,369,12.75,9.925,6.24
29143,Missouri,New Madrid County,18030,33846,41.3,12437,878,690,4573,67,163,749,540,209,651,471,180,772,496,276,926,612,314,12.608,5.03,3.564
29157,Missouri,Perry County,19135,54935,40.5,13028,1434,689,5758,149,256,716,648,68,808,748,60,991,856,135,946,862,84,16.296,7.034,4.446
29167,Missouri,Polk County,31347,44805,37.5,19983,2532,1524,7806,196,438,1689,1234,455,1983,1597,386,1531,1157,374,1453,1167,286,20.297,8.122,5.611
29173,Missouri,Ralls County,10208,50161,44.7,7247,602,356,3289,64,172,370,331,39,358,337,21,416,328,88,419,345,74,13.219,7.175,5.23
29177,Missouri,Ray County,22859,57270,41.8,15756,1627,643,6730,236,234,1039,666,373,816,754,62,1070,903,167,1065,864,201,14.407,6.984,3.477
29209,Missouri,Stone County,31529,43292,52.7,24153,3099,1348,10302,380,759,1119,865,254,874,583,291,1066,791,275,1091,771,320,18.412,11.056,7.368
29179,Missouri,Reynolds County,6361,40265,46,4628,322,130,2062,11,73,215,149,66,162,138,24,243,174,69,307,199,108,9.767,4.074,3.54
29189,Missouri,St. Louis County,999539,62931,40.3,688617,171204,123633,279767,8814,17414,43340,35238,8102,43741,37172,6569,54303,45281,9022,58913,51557,7356,42.816,9.375,6.224
29201,Missouri,Scott County,38858,41628,40,26329,2155,1435,10497,160,507,1729,1185,544,1706,1343,363,1891,1526,365,2177,1657,520,13.635,6.354,4.83
29009,Missouri,Barry County,35398,40638,43.2,24419,2081,1034,9748,274,503,1427,929,498,1394,909,485,1546,1071,475,1496,1046,450,12.756,7.971,5.16
29011,Missouri,Barton County,11942,41184,40.6,8091,962,446,3418,94,191,413,299,114,387,301,86,572,333,239,599,485,114,17.402,8.338,5.588
29019,Missouri,Boone County,174589,52005,30.6,103554,26835,20714,37742,835,1779,16755,15385,1370,17866,16521,1345,11267,9490,1777,11760,9917,1843,45.917,6.926,4.714
29039,Missouri,Cedar County,13862,35930,44,9623,859,468,4137,118,224,467,291,176,370,269,101,568,420,148,698,527,171,13.79,8.267,5.415
29051,Missouri,Cole County,76749,54216,38.2,52300,10767,5678,19907,518,959,3132,2532,600,3077,2609,468,4014,3236,778,4415,3365,1050,31.444,7.42,4.817
29055,Missouri,Crawford County,24387,37171,41.6,16860,1257,628,6640,252,361,888,562,326,900,547,353,1283,819,464,1328,1025,303,11.18,9.232,5.437
29073,Missouri,Gasconade County,14769,50687,45.9,10592,1194,622,4689,109,115,506,401,105,584,526,58,663,545,118,659,544,115,17.145,4.777,2.453
29093,Missouri,Iron County,10286,36457,45.3,7387,559,306,2931,60,95,445,251,194,348,253,95,446,291,155,442,317,125,11.71,5.288,3.241
29117,Missouri,Livingston County,15025,45929,40.7,10655,1335,670,3883,38,142,465,333,132,485,392,93,725,521,204,820,632,188,18.817,4.636,3.657
29121,Missouri,Macon County,15319,38903,43,10557,1081,531,4466,87,178,615,467,148,511,383,128,747,632,115,673,606,67,15.269,5.934,3.986
29135,Missouri,Moniteau County,15904,50897,38.6,10772,1422,462,4125,95,112,617,363,254,536,362,174,648,484,164,796,681,115,17.49,5.018,2.715
29149,Missouri,Oregon County,10779,32070,46.3,7611,597,376,3381,102,260,370,211,159,413,192,221,456,279,177,376,287,89,12.784,10.707,7.69
29155,Missouri,Pemiscot County,17344,32468,37.7,11212,815,532,3631,107,100,741,561,180,763,477,286,820,598,222,1002,723,279,12.014,5.701,2.754
29159,Missouri,Pettis County,42309,43097,37.9,28073,3194,1771,10780,230,478,1647,1277,370,1983,1607,376,2481,1660,821,2396,1691,705,17.686,6.568,4.434
29186,Missouri,Ste. Genevieve County,17882,50959,43,12563,1218,736,5544,143,350,657,543,114,727,475,252,903,812,91,672,594,78,15.554,8.892,6.313
29203,Missouri,Shannon County,8273,31202,44.8,5822,556,273,2264,40,154,270,98,172,278,204,74,405,339,66,406,254,152,14.239,8.569,6.802
29175,Missouri,Randolph County,24987,44754,39.2,17130,1551,954,6298,232,201,1071,861,210,1058,788,270,1234,873,361,1207,984,223,14.623,6.875,3.191
29067,Missouri,Douglas County,13391,33003,47.3,9636,601,306,3964,119,312,510,292,218,443,290,153,548,386,162,575,463,112,9.413,10.873,7.871
29069,Missouri,Dunklin County,30905,32348,39.4,20341,1658,956,8071,175,519,1219,824,395,1106,742,364,1342,921,421,1590,1158,432,12.851,8.599,6.43
29071,Missouri,Franklin County,102413,53849,40.7,70279,9306,5005,30074,987,1776,4259,3324,935,3841,3364,477,5541,4487,1054,5671,4798,873,20.363,9.187,5.905
29083,Missouri,Henry County,21834,41089,44,15529,1716,754,6812,176,331,721,575,146,737,605,132,1035,728,307,1077,807,270,15.906,7.443,4.859
29089,Missouri,Howard County,10144,50356,38.9,6573,1085,594,2817,55,124,619,575,44,569,535,34,493,405,88,552,446,106,25.544,6.354,4.402
29095,Missouri,Jackson County,688554,50652,36.6,464577,89255,50924,164551,5013,10169,30412,22253,8159,32251,25629,6622,45488,35240,10248,47137,38315,8822,30.173,9.226,6.18
29109,Missouri,Lawrence County,38131,41673,39.7,25502,2845,1214,10351,308,528,1546,1153,393,1350,1033,317,1921,1313,608,1960,1370,590,15.916,8.077,5.101
29131,Missouri,Miller County,24947,41461,41.1,17040,1752,975,7116,299,369,875,566,309,1035,900,135,1262,938,324,1308,1055,253,16.004,9.387,5.185
29169,Missouri,Pulaski County,53132,51137,27.6,29223,4860,2681,7404,124,499,2239,1854,385,1864,1333,531,2542,1990,552,3129,2820,309,25.805,8.414,6.74
29171,Missouri,Putnam County,4846,37028,46.7,3438,434,189,1423,69,66,163,72,91,152,87,65,252,178,74,214,214,0,18.121,9.487,4.638
29213,Missouri,Taney County,54308,39661,41.9,37285,4460,2161,13177,524,814,2675,1776,899,2683,1894,789,2633,1805,828,2810,1940,870,17.758,10.154,6.177
29215,Missouri,Texas County,25714,35571,42.3,17866,1718,745,6891,138,332,1018,662,356,745,560,185,1035,653,382,1222,973,249,13.786,6.82,4.818
29021,Missouri,Buchanan County,89425,48652,37.1,60333,7885,4130,21046,590,940,4090,3261,829,4337,3364,973,5420,4167,1253,5236,4256,980,19.914,7.27,4.466
29025,Missouri,Caldwell County,9046,44975,42.9,6207,780,302,2810,33,132,289,162,127,252,208,44,388,311,77,423,372,51,17.432,5.872,4.698
29027,Missouri,Callaway County,44793,53180,38.3,30293,4381,2160,11563,208,487,2229,1974,255,2309,1931,378,2115,1770,345,2193,1775,418,21.592,6.011,4.212
29037,Missouri,Cass County,101888,65352,39.5,68556,11504,6152,29212,809,1376,3728,3052,676,3904,3326,578,5571,4627,944,5338,4516,822,25.754,7.48,4.71
29049,Missouri,Clinton County,20495,57591,41.1,14114,1803,806,6147,142,350,739,591,148,778,654,124,1012,812,200,989,698,291,18.485,8.004,5.694
29053,Missouri,Cooper County,17620,46547,39.2,12161,1792,726,4567,127,199,769,613,156,649,585,64,779,641,138,877,796,81,20.706,7.138,4.357
29059,Missouri,Dallas County,16441,41441,43.5,11351,782,595,4506,104,160,569,437,132,546,335,211,779,404,375,820,547,273,12.131,5.859,3.551
29075,Missouri,Gentry County,6688,43777,41.3,4514,639,264,1929,47,56,264,215,49,285,240,45,301,223,78,350,284,66,20.004,5.34,2.903
29085,Missouri,Hickory County,9352,34746,54.8,7275,427,289,3267,151,226,237,140,97,223,206,17,303,205,98,315,185,130,9.842,11.54,6.918
29113,Missouri,Lincoln County,54800,58603,37.3,35866,3830,1792,14404,497,975,2271,2019,252,2321,1875,446,2989,2502,487,3138,2833,305,15.675,10.219,6.769
29133,Missouri,Mississippi County,13916,32212,39.4,9809,791,323,3106,113,160,479,221,258,398,304,94,675,462,213,657,484,173,11.357,8.789,5.151
29137,Missouri,Monroe County,8676,42011,45.2,6169,627,261,2691,104,74,283,184,99,312,223,89,396,312,84,358,249,109,14.395,6.615,2.75
29145,Missouri,Newton County,58237,46723,39.4,39048,5053,2528,15867,404,823,2716,2001,715,2228,1822,406,2828,2026,802,3233,2476,757,19.415,7.733,5.187
29153,Missouri,Ozark County,9328,32021,51.1,6962,522,424,3193,76,129,295,191,104,257,227,30,328,194,134,359,284,75,13.588,6.42,4.04
29163,Missouri,Pike County,18517,45112,39.2,12759,1471,512,4804,103,236,688,557,131,564,453,111,763,610,153,866,781,85,15.542,7.057,4.913
29183,Missouri,St. Charles County,385115,78380,38,258840,62970,33108,114273,3334,5330,16973,15225,1748,16203,14828,1375,22482,19464,3018,23005,20495,2510,37.119,7.582,4.664
29129,Missouri,Mercer County,3669,43314,43.6,2484,267,170,1056,17,33,125,75,50,104,87,17,179,135,44,146,93,53,17.593,4.735,3.125
29123,Missouri,Madison County,12226,37484,41.7,8550,787,279,3464,129,133,494,389,105,603,397,206,646,534,112,654,579,75,12.468,7.564,3.839
29229,Missouri,Wright County,18304,31290,42,12401,866,595,5111,150,304,661,371,290,592,406,186,905,520,385,863,658,205,11.781,8.883,5.948
29047,Missouri,Clay County,236068,65675,36.8,158358,34344,16250,61967,1901,2675,10162,7663,2499,9650,8071,1579,14488,12289,2199,15264,13373,1891,31.949,7.385,4.317
29217,Missouri,Vernon County,20665,41479,40.7,13820,1428,967,5580,165,252,793,591,202,911,672,239,1045,725,320,1038,709,329,17.33,7.473,4.516
29065,Missouri,Dent County,15566,38829,44.1,10953,915,499,4279,106,350,531,324,207,546,339,207,771,422,349,699,441,258,12.91,10.657,8.179
29195,Missouri,Saline County,23010,41567,37.9,15142,1744,1089,6006,145,261,1324,1176,148,1081,856,225,1184,991,193,1240,1063,177,18.71,6.76,4.346
29147,Missouri,Nodaway County,22744,41370,29,12572,1916,1453,4761,111,135,2707,2475,232,3015,2636,379,954,799,155,1002,864,138,26.798,5.167,2.836
29227,Missouri,Worth County,2053,48214,47.5,1490,185,99,671,4,26,67,46,21,66,56,10,98,76,22,109,86,23,19.06,4.471,3.875
29041,Missouri,Chariton County,7586,43186,45.7,5352,554,322,2186,32,72,285,226,59,273,234,39,297,234,63,305,258,47,16.368,4.758,3.294
29079,Missouri,Grundy County,10111,41092,40.9,6814,749,471,2706,15,122,555,373,182,336,251,85,602,393,209,532,422,110,17.904,5.063,4.508
29141,Missouri,Morgan County,20097,34776,46.4,14376,1178,631,5859,108,474,645,273,372,699,366,333,862,434,428,829,506,323,12.583,9.933,8.09
29223,Missouri,Wayne County,13369,35135,46.9,9617,832,329,4204,74,205,404,273,131,365,264,101,596,418,178,643,452,191,12.072,6.637,4.876
29017,Missouri,Bollinger County,12347,40791,43.9,8687,575,242,3872,88,247,414,315,99,480,383,97,594,418,176,566,476,90,9.405,8.652,6.379
29031,Missouri,Cape Girardeau County,78013,49554,36.3,50086,9378,5554,19353,419,895,5391,4756,635,5652,5097,555,4228,3448,780,4325,3409,916,29.813,6.79,4.625
29205,Missouri,Shelby County,6084,42593,41.9,4188,475,184,1806,20,96,203,121,82,209,130,79,277,222,55,290,194,96,15.735,6.423,5.316
29225,Missouri,Webster County,37558,45185,37.4,24355,2439,1390,9684,334,487,1557,934,623,1431,1083,348,1732,1233,499,1841,1517,324,15.722,8.478,5.029
29005,Missouri,Atchison County,5335,45259,47.8,3939,683,233,1761,72,98,184,98,86,170,147,23,266,221,45,245,208,37,23.255,9.654,5.565
29013,Missouri,Bates County,16405,45605,41.6,11218,1086,592,4939,118,256,543,412,131,594,450,144,794,622,172,885,662,223,14.958,7.572,5.183
29015,Missouri,Benton County,18918,35097,53.2,14558,1005,685,6495,169,442,465,247,218,502,434,68,649,487,162,661,502,159,11.609,9.407,6.805
30017,Montana,Custer County,11895,53050,41,8329,1351,511,3426,33,152,427,342,85,480,377,103,670,530,140,738,668,70,22.356,5.4,4.437
30041,Montana,Hill County,16468,45269,34.4,10249,1858,571,3872,81,230,933,759,174,759,612,147,992,799,193,966,829,137,23.7,8.032,5.94
30015,Montana,Chouteau County,5812,39577,40.9,3896,763,233,1432,31,83,268,183,85,254,159,95,267,193,74,258,208,50,25.565,7.961,5.796
30103,Montana,Treasure County,790,42454,49.2,576,102,31,253,4,15,33,33,0,29,23,6,27,23,4,36,36,0,23.09,7.51,5.929
30071,Montana,Phillips County,4139,42101,46.4,2849,394,122,1275,13,26,180,105,75,118,90,28,139,110,29,186,143,43,18.112,3.059,2.039
30075,Montana,Powder River County,1610,51136,51.4,1226,260,54,488,25,13,70,57,13,48,10,38,52,37,15,58,36,22,25.612,7.787,2.664
30053,Montana,Lincoln County,19249,36934,52.1,14579,2213,757,6550,272,616,547,359,188,408,332,76,694,465,229,722,563,159,20.372,13.557,9.405
30067,Montana,Park County,16001,44920,46.4,12028,2771,1326,5355,111,544,503,428,75,454,427,27,810,547,263,879,738,141,34.062,12.232,10.159
30085,Montana,Roosevelt County,11218,39219,30.2,6443,718,278,1852,18,33,619,332,287,545,308,237,627,309,318,645,439,206,15.459,2.754,1.782
30005,Montana,Blaine County,6646,35506,34,4025,666,166,1366,42,62,291,139,152,261,140,121,344,177,167,348,251,97,20.671,7.613,4.539
30051,Montana,Liberty County,2245,46641,48.4,1656,208,62,525,10,16,64,50,14,104,104,0,131,88,43,87,84,3,16.304,4.952,3.048
30097,Montana,Sweet Grass County,3646,49761,50.1,2657,528,148,1142,15,93,110,80,30,93,93,0,125,98,27,94,78,16,25.442,9.457,8.144
30083,Montana,Richland County,11405,66572,38,7551,1085,400,2832,38,83,484,342,142,528,374,154,660,520,140,635,515,120,19.666,4.273,2.931
30099,Montana,Teton County,6040,51060,44.5,4177,689,301,1682,11,110,220,186,34,215,170,45,237,187,50,285,239,46,23.701,7.194,6.54
30079,Montana,Prairie County,1325,50850,51,962,164,33,487,2,4,32,19,13,20,12,8,20,20,0,14,14,0,20.478,1.232,0.821
30101,Montana,Toole County,5031,46735,41.9,3620,396,141,1086,4,28,190,115,75,172,148,24,228,199,29,201,185,16,14.834,2.947,2.578
30035,Montana,Glacier County,13677,29201,31,7946,1078,383,2468,26,28,764,352,412,573,199,374,749,202,547,822,366,456,18.387,2.188,1.135
30025,Montana,Fallon County,2925,56806,38.1,1961,212,100,840,29,22,100,100,0,84,68,16,200,170,30,181,117,64,15.91,6.071,2.619
30019,Montana,Daniels County,1788,53591,45.5,1293,244,54,673,0,37,81,81,0,39,23,16,66,40,26,52,43,9,23.047,5.498,5.498
30095,Montana,Stillwater County,9342,61998,46.5,6714,1204,473,2953,76,139,328,279,49,248,178,70,344,295,49,377,340,37,24.978,7.281,4.707
30037,Montana,Golden Valley County,747,43854,54,574,97,21,234,9,11,9,5,4,11,7,4,12,12,0,19,11,8,20.557,8.547,4.701
30045,Montana,Judith Basin County,1965,43281,51.7,1533,363,71,662,19,36,69,63,6,54,28,26,86,74,12,104,75,29,28.311,8.308,5.438
30093,Montana,Silver Bow County,34514,40480,39.9,23241,4123,1903,10138,223,474,2223,1714,509,1967,1646,321,1839,1558,281,1503,1269,234,25.928,6.875,4.675
30023,Montana,Deer Lodge County,9131,41235,47.4,6812,768,394,2791,48,103,398,227,171,275,224,51,296,249,47,256,243,13,17.058,5.41,3.69
30043,Montana,Jefferson County,11625,64911,47.9,8435,1963,810,3840,86,227,384,323,61,322,256,66,437,323,114,407,316,91,32.875,8.151,5.911
30039,Montana,Granite County,3206,49063,53.1,2404,373,227,948,29,59,34,23,11,67,54,13,89,71,18,82,59,23,24.958,9.283,6.224
30055,Montana,McCone County,1728,46193,49.1,1233,196,18,581,7,38,34,30,4,43,39,4,115,106,9,78,78,0,17.356,7.745,6.54
30107,Montana,Wheatland County,2108,37222,39.4,1384,198,49,529,12,19,63,34,29,76,51,25,88,68,20,117,100,17,17.847,5.86,3.592
30057,Montana,Madison County,7902,47900,53,6225,1276,613,2683,141,253,239,185,54,150,138,12,396,294,102,351,233,118,30.345,14.685,9.43
30087,Montana,Rosebud County,9292,54709,36.5,5846,859,238,2312,49,112,439,260,179,346,217,129,396,308,88,417,293,124,18.765,6.964,4.844
30091,Montana,Sheridan County,3568,51940,46.9,2581,415,123,1261,19,53,134,102,32,122,109,13,207,183,24,175,149,26,20.845,5.71,4.203
30011,Montana,Carter County,1320,45347,51.6,973,136,26,469,8,23,42,29,13,51,51,0,67,48,19,56,32,24,16.65,6.61,4.904
30021,Montana,Dawson County,9324,59622,41.9,6456,941,337,2808,7,86,449,379,70,333,312,21,504,436,68,455,354,101,19.796,3.312,3.063
30003,Montana,Big Horn County,13290,47276,29.9,7572,888,442,2273,40,60,700,206,494,606,247,359,654,271,383,764,326,438,17.565,4.399,2.64
30007,Montana,Broadwater County,5755,55295,46.3,4210,866,337,2020,61,140,150,107,43,105,105,0,256,190,66,204,171,33,28.575,9.95,6.931
30047,Montana,Lake County,29518,42582,41.8,20121,3318,1913,8466,287,993,1127,614,513,1044,602,442,1377,739,638,1368,902,466,25.998,15.119,11.729
30049,Montana,Lewis and Clark County,66290,60789,41.1,46485,11201,6242,18925,513,812,2703,2418,285,2479,2186,293,3701,3030,671,3925,3427,498,37.524,7.001,4.291
30073,Montana,Pondera County,6081,44597,40.5,4113,680,228,1603,40,49,226,167,59,203,151,52,313,244,69,315,206,109,22.076,5.552,3.057
30111,Montana,Yellowstone County,156332,57955,38.3,106431,22324,9833,43537,1564,2602,6689,5147,1542,6292,5447,845,9524,7707,1817,9870,8220,1650,30.214,9.569,5.977
30063,Montana,Missoula County,114231,49412,35.4,75530,19658,12496,28234,994,1935,8148,6726,1422,8124,6888,1236,8221,6590,1631,7734,6604,1130,42.571,10.374,6.853
30081,Montana,Ravalli County,41387,44733,48.5,30399,5102,2940,12532,811,1225,1434,754,680,1233,818,415,1488,1028,460,1616,1236,380,26.455,16.246,9.775
30105,Montana,Valley County,7561,55267,44.4,5325,833,288,2533,28,116,224,183,41,396,390,6,388,281,107,320,289,31,21.052,5.685,4.58
30013,Montana,Cascade County,81816,46827,38.4,55331,10120,4994,22559,660,1060,3248,2255,993,3621,2986,635,4405,3481,924,4839,4176,663,27.316,7.624,4.699
30027,Montana,Fergus County,11327,47110,45.7,8301,1832,615,3466,134,136,373,272,101,287,253,34,525,376,149,674,464,210,29.478,7.79,3.924
30033,Montana,Garfield County,1086,47188,43.8,754,106,26,365,1,15,54,37,17,49,38,11,44,38,6,66,58,8,17.507,4.384,4.11
30061,Montana,Mineral County,4194,40117,52.1,3089,295,175,1198,28,122,151,114,37,139,139,0,129,102,27,124,121,3,15.215,12.521,10.184
30069,Montana,Petroleum County,453,46429,51.7,368,68,25,134,3,5,8,5,3,4,4,0,21,12,9,12,10,2,25.272,5.97,3.731
30077,Montana,Powell County,6852,44352,45.6,5290,582,380,1661,27,78,239,137,102,165,147,18,199,153,46,187,135,52,18.185,6.321,4.696
30089,Montana,Sanders County,11414,36445,52.7,8687,1137,369,3785,193,376,270,168,102,249,144,105,388,258,130,432,222,210,17.336,15.033,9.934
30109,Montana,Wibaux County,1121,47132,49.4,811,159,25,394,12,24,28,28,0,32,3,29,33,33,0,46,39,7,22.688,9.137,6.091
30031,Montana,Gallatin County,100733,59397,33.4,63818,20309,10847,25089,1092,1436,9075,8100,975,7156,6626,530,7448,6025,1423,6716,5856,860,48.82,10.076,5.724
30059,Montana,Meagher County,2000,41343,43.9,1390,212,61,547,36,22,23,7,16,57,35,22,91,75,16,99,90,9,19.64,10.603,4.022
30009,Montana,Carbon County,10466,56988,50,7986,1680,807,3608,123,235,264,188,76,246,205,41,378,275,103,450,313,137,31.142,9.922,6.513
30001,Montana,Beaverhead County,9360,43880,43,6378,1420,682,2623,39,138,545,458,87,600,563,37,462,361,101,410,287,123,32.957,6.748,5.261
30029,Montana,Flathead County,96147,51410,42.3,67650,13384,6307,27350,1295,2297,3440,2559,881,3348,2704,644,5056,3888,1168,5249,4373,876,29.107,13.133,8.399
30065,Montana,Musselshell County,4766,38156,49.1,3446,303,213,1453,35,141,107,102,5,110,88,22,190,159,31,193,150,43,14.974,12.113,9.704
31069,Nebraska,Garden County,1913,48125,51.7,1509,263,102,721,17,22,37,32,5,31,31,0,43,36,7,70,52,18,24.188,5.409,3.051
31091,Nebraska,Hooker County,684,41607,58,540,88,50,236,2,13,4,4,0,33,31,2,40,40,0,22,22,0,25.556,6.356,5.508
31123,Nebraska,Morrill County,4903,44201,42.9,3400,476,167,1439,50,71,142,108,34,131,114,17,230,158,72,245,197,48,18.912,8.409,4.934
31127,Nebraska,Nemaha County,7041,55536,38,4572,897,381,2023,16,49,509,476,33,360,328,32,363,241,122,359,328,31,27.953,3.213,2.422
31159,Nebraska,Seward County,17045,63095,38.3,10824,2031,1006,4605,65,103,1054,974,80,971,830,141,888,823,65,749,675,74,28.058,3.648,2.237
31171,Nebraska,Thomas County,643,53173,42.1,459,112,21,204,4,6,17,17,0,15,15,0,48,48,0,30,30,0,28.976,4.902,2.941
31043,Nebraska,Dakota County,20529,52401,33.8,12588,1048,538,4891,70,237,1067,770,297,936,656,280,1091,784,307,1340,948,392,12.599,6.277,4.846
31181,Nebraska,Webster County,3597,43831,46.1,2517,355,218,1201,31,49,138,107,31,102,73,29,166,129,37,120,112,8,22.765,6.661,4.08
31003,Nebraska,Antelope County,6406,46949,45.9,4480,614,221,2118,35,68,240,188,52,199,173,26,300,250,50,282,245,37,18.638,4.863,3.211
31029,Nebraska,Chase County,3803,54568,44.4,2697,405,119,1345,17,62,148,99,49,101,70,31,153,133,20,139,113,26,19.429,5.874,4.61
31023,Nebraska,Butler County,8105,52448,43.5,5572,793,247,2718,37,81,297,267,30,239,174,65,366,311,55,333,304,29,18.665,4.341,2.98
31035,Nebraska,Clay County,6264,54167,43.5,4298,559,207,2021,24,62,267,229,38,223,171,52,294,215,79,275,207,68,17.822,4.255,3.068
31005,Nebraska,Arthur County,421,41250,43.3,264,60,19,112,2,8,23,23,0,2,2,0,9,7,2,13,9,4,29.924,8.929,7.143
31041,Nebraska,Custer County,10836,48836,43.5,7549,1100,537,3447,63,175,348,229,119,358,259,99,519,421,98,486,404,82,21.685,6.905,5.077
31061,Nebraska,Franklin County,3019,49453,50.7,2243,338,110,1142,10,32,80,70,10,91,84,7,120,108,12,120,112,8,19.973,3.678,2.802
31067,Nebraska,Gage County,21632,52223,44.2,15359,2244,879,6338,85,237,767,685,82,674,587,87,1046,870,176,1007,902,105,20.333,5.08,3.739
31081,Nebraska,Hamilton County,9149,61944,42.3,6218,1120,476,3027,70,51,315,273,42,308,292,16,443,424,19,394,350,44,25.667,3.997,1.685
31115,Nebraska,Loup County,537,58625,52.8,401,68,24,200,4,7,15,13,2,17,17,0,27,22,5,20,18,2,22.943,5.5,3.5
31095,Nebraska,Jefferson County,7276,46576,45.7,5232,571,199,2430,15,92,215,157,58,272,263,9,317,248,69,340,317,23,14.717,4.403,3.786
31099,Nebraska,Kearney County,6547,53207,40.6,4485,760,242,1906,19,84,226,207,19,239,227,12,289,225,64,331,322,9,22.341,5.404,4.407
31101,Nebraska,Keith County,8129,45078,49.7,6007,950,374,2692,87,58,293,227,66,261,249,12,281,170,111,335,243,92,22.041,5.386,2.155
31119,Nebraska,Madison County,35062,49865,36.9,22903,3250,1419,9313,131,408,1710,1404,306,1684,1397,287,2087,1661,426,1985,1703,282,20.386,5.788,4.381
31135,Nebraska,Perkins County,2904,58125,43.3,2085,340,138,983,8,34,94,86,8,29,29,0,155,122,33,188,167,21,22.926,4.273,3.459
31137,Nebraska,Phelps County,9163,56408,42.1,6274,1185,447,2726,83,142,289,283,6,288,262,26,512,456,56,451,400,51,26.012,8.254,5.209
31155,Nebraska,Saunders County,20953,65015,41,14199,2583,1173,6445,154,308,691,568,123,664,617,47,959,885,74,983,853,130,26.453,7.168,4.779
31157,Nebraska,Scotts Bluff County,36509,47975,39.5,24349,3663,1706,9933,353,549,1593,1082,511,1473,1098,375,1786,1299,487,1978,1496,482,22.05,9.081,5.527
31179,Nebraska,Wayne County,9409,58093,31.7,5381,1249,493,2289,26,27,1021,945,76,881,855,26,457,389,68,425,310,115,32.373,2.315,1.18
31103,Nebraska,Keya Paha County,720,48864,50.2,533,71,39,242,0,4,27,27,0,23,18,5,42,30,12,14,8,6,20.638,1.653,1.653
31105,Nebraska,Kimball County,3688,43017,46,2612,316,140,1031,15,32,131,83,48,59,39,20,137,101,36,192,115,77,17.458,4.559,3.104
31107,Nebraska,Knox County,8496,48072,47.2,5899,886,343,2691,49,71,261,221,40,236,175,61,331,264,67,315,275,40,20.834,4.459,2.638
31111,Nebraska,Lincoln County,35569,55875,40.4,24416,3630,1788,9654,204,404,1237,1022,215,1351,996,355,1904,1401,503,1793,1439,354,22.19,6.298,4.185
31121,Nebraska,Merrick County,7829,53536,43.5,5476,775,188,2431,92,50,288,228,60,311,275,36,369,315,54,329,277,52,17.586,5.841,2.057
31139,Nebraska,Pierce County,7175,55417,41.7,4862,800,294,2406,54,86,243,211,32,224,199,25,350,319,31,335,326,9,22.501,5.819,3.574
31165,Nebraska,Sioux County,1256,45375,51.6,909,204,38,438,23,39,41,41,0,62,51,11,60,51,9,81,50,31,26.623,14.155,8.904
31021,Nebraska,Burt County,6546,50174,46.6,4673,660,232,2187,26,62,180,117,63,175,149,26,284,253,31,301,250,51,19.088,4.024,2.835
31025,Nebraska,Cass County,25513,68284,41.9,17389,3177,1480,8093,264,453,908,765,143,771,716,55,1160,1043,117,1143,986,157,26.781,8.86,5.597
31039,Nebraska,Cuming County,9039,50734,44,6111,958,339,2580,17,54,388,283,105,300,260,40,388,326,62,358,329,29,21.224,2.752,2.093
31051,Nebraska,Dixon County,5765,57036,42.2,3885,503,229,1853,19,59,231,210,21,199,163,36,244,186,58,250,246,4,18.842,4.209,3.184
31057,Nebraska,Dundy County,2017,44653,43.6,1363,209,79,595,3,36,48,30,18,90,58,32,65,58,7,85,69,16,21.13,6.555,6.05
31075,Nebraska,Grant County,682,45833,48.6,483,89,22,223,8,13,16,16,0,22,19,3,36,23,13,33,27,6,22.981,9.417,5.83
31077,Nebraska,Greeley County,2436,47218,45.9,1697,205,89,817,12,12,64,51,13,61,49,12,98,81,17,106,80,26,17.325,2.938,1.469
31079,Nebraska,Hall County,61233,53807,35.8,39161,5391,2360,14078,214,668,2726,1819,907,2555,1884,671,3764,2891,873,3453,2688,765,19.793,6.265,4.745
31085,Nebraska,Hayes County,957,44946,42.7,698,101,19,283,8,6,30,27,3,21,14,7,77,39,38,52,22,30,17.192,4.947,2.12
31131,Nebraska,Otoe County,15875,54605,41.7,10819,1691,628,4665,124,312,679,538,141,606,505,101,741,617,124,708,579,129,21.435,9.346,6.688
31145,Nebraska,Red Willow County,10870,42882,40.8,7352,928,449,3453,31,106,402,292,110,467,442,25,632,550,82,513,446,67,18.73,3.968,3.07
31027,Nebraska,Cedar County,8561,57208,44.1,5785,769,298,2830,37,95,301,227,74,275,261,14,378,341,37,334,272,62,18.444,4.664,3.357
31045,Nebraska,Dawes County,8972,46146,34,5404,1152,845,2222,40,61,861,628,233,756,621,135,397,345,52,431,337,94,36.954,4.545,2.745
31097,Nebraska,Johnson County,5200,49564,41.1,3745,451,197,1382,20,63,125,107,18,113,78,35,169,155,14,166,161,5,17.303,6.006,4.559
31033,Nebraska,Cheyenne County,10012,58770,40.7,6914,1422,394,3109,66,142,370,306,64,358,343,15,570,524,46,626,489,137,26.266,6.69,4.567
31047,Nebraska,Dawson County,23925,51238,35.8,15275,1687,728,5947,179,189,1002,742,260,899,652,247,1462,1163,299,1356,1005,351,15.81,6.188,3.178
31071,Nebraska,Garfield County,1958,46509,51.4,1409,197,78,702,10,23,76,76,0,68,68,0,92,85,7,76,66,10,19.517,4.701,3.276
31117,Nebraska,McPherson County,432,60714,48.5,322,63,18,128,3,7,4,4,0,7,3,4,19,19,0,21,21,0,25.155,7.813,5.469
31125,Nebraska,Nance County,3569,45428,45.4,2517,256,205,1219,45,37,100,100,0,105,105,0,174,141,33,147,118,29,18.315,6.727,3.035
31133,Nebraska,Pawnee County,2704,42176,50.1,1983,235,81,994,15,38,101,53,48,52,13,39,79,60,19,143,121,22,15.935,5.332,3.823
31167,Nebraska,Stanton County,6020,57534,41,4043,552,161,1960,63,92,234,186,48,176,135,41,295,233,62,334,328,6,17.635,7.908,4.694
31175,Nebraska,Valley County,4252,50270,46,3059,473,149,1385,5,55,122,70,52,151,134,17,231,171,60,207,163,44,20.333,4.332,3.971
31183,Nebraska,Wheeler County,846,49706,50.2,650,87,37,265,9,11,18,18,0,19,17,2,37,36,1,23,14,9,19.077,7.547,4.151
31083,Nebraska,Harlan County,3469,46750,49.5,2498,377,90,1226,37,32,99,83,16,98,83,15,136,105,31,125,100,25,18.695,5.628,2.61
31185,Nebraska,York County,13832,59966,40.9,9379,1843,790,3973,146,139,681,557,124,465,422,43,657,589,68,671,584,87,28.073,7.173,3.499
31009,Nebraska,Blaine County,502,52000,46.8,356,51,35,141,0,5,26,14,12,10,0,10,16,15,1,18,18,0,24.157,3.546,3.546
31019,Nebraska,Buffalo County,48834,55053,32.9,29817,6777,3241,11931,312,564,3573,2971,602,3787,3350,437,3205,2625,580,2904,2593,311,33.598,7.342,4.727
31037,Nebraska,Colfax County,10616,54876,33.7,6504,604,335,2519,53,74,500,459,41,365,350,15,635,487,148,599,363,236,14.437,5.042,2.938
31049,Nebraska,Deuel County,1901,53438,46.1,1365,166,81,626,15,22,87,33,54,72,49,23,107,78,29,100,84,16,18.095,5.911,3.514
31087,Nebraska,Hitchcock County,2860,41582,47.1,2052,216,142,936,29,17,74,59,15,82,64,18,132,102,30,130,109,21,17.446,4.915,1.816
31113,Nebraska,Logan County,919,50278,38.9,600,119,17,253,14,39,29,15,14,29,29,0,35,35,0,23,17,6,22.667,20.949,15.415
31141,Nebraska,Platte County,32875,58679,38.3,21469,3184,1432,9207,160,362,1382,1144,238,1383,1225,158,1795,1437,358,1635,1471,164,21.501,5.67,3.932
31143,Nebraska,Polk County,5244,63667,45.5,3633,566,192,1637,32,17,169,90,79,196,170,26,205,150,55,189,151,38,20.864,2.993,1.038
31169,Nebraska,Thayer County,5133,48151,48.2,3708,565,201,1814,16,42,176,147,29,160,137,23,189,186,3,190,185,5,20.658,3.197,2.315
31013,Nebraska,Box Butte County,11200,56328,40.5,7514,963,344,3305,51,108,383,359,24,438,299,139,544,487,57,479,356,123,17.394,4.811,3.268
31017,Nebraska,Brown County,3058,42773,48.9,2302,287,131,1075,7,39,28,28,0,85,47,38,186,157,29,122,116,6,18.158,4.279,3.628
31001,Nebraska,Adams County,31564,51721,37.9,20397,2989,1809,8645,140,248,1768,1524,244,1561,1453,108,1726,1415,311,1602,1377,225,23.523,4.488,2.869
31161,Nebraska,Sheridan County,5241,41209,46.1,3751,694,272,1622,27,68,146,99,47,147,93,54,260,172,88,220,166,54,25.753,5.857,4.192
31109,Nebraska,Lancaster County,306357,55747,33.2,189221,45943,25696,72645,1815,3125,22888,19665,3223,22676,20257,2419,19597,15880,3717,17997,15333,2664,37.86,6.8,4.302
31011,Nebraska,Boone County,5357,53854,45,3709,533,202,1773,5,68,214,183,31,186,160,26,244,190,54,227,201,26,19.817,4.117,3.835
31129,Nebraska,Nuckolls County,4318,42055,49.4,3167,383,223,1500,12,19,149,83,66,124,106,18,193,154,39,187,150,37,19.135,2.067,1.267
31149,Nebraska,Rock County,1381,52361,51.9,1010,146,45,498,2,8,82,67,15,63,36,27,42,38,4,34,30,4,18.911,2.008,1.606
31007,Nebraska,Banner County,728,55000,48.1,517,62,28,205,0,8,20,14,6,14,14,0,39,31,8,16,14,2,17.408,3.902,3.902
31063,Nebraska,Frontier County,2624,52090,45.5,1789,223,126,854,6,37,100,87,13,135,111,24,94,90,4,109,104,5,19.508,5.035,4.333
31163,Nebraska,Sherman County,3048,48704,49.3,2213,280,124,1124,19,64,98,81,17,96,92,4,105,94,11,105,98,7,18.256,7.384,5.694
31055,Nebraska,Douglas County,549706,58640,34.3,356837,88266,47116,130582,4282,7446,25996,21558,4438,26396,22305,4091,38481,30560,7921,38761,32811,5950,37.939,8.981,5.702
31147,Nebraska,Richardson County,8045,46839,47.6,5858,866,272,2938,18,95,316,314,2,223,206,17,300,235,65,378,276,102,19.426,3.846,3.233
31093,Nebraska,Howard County,6385,53648,43.3,4425,682,208,2039,36,112,204,165,39,210,192,18,299,255,44,273,228,45,20.113,7.258,5.493
31089,Nebraska,Holt County,10293,52050,44.1,7159,1061,439,3288,72,121,356,309,47,280,226,54,492,429,63,410,380,30,20.953,5.87,3.68
31065,Nebraska,Furnas County,4814,43400,46.1,3395,506,113,1559,27,70,161,134,27,126,117,9,191,158,33,221,185,36,18.233,6.222,4.49
31073,Nebraska,Gosper County,2019,61769,49.5,1484,279,78,616,8,22,64,59,5,43,43,0,65,53,12,100,77,23,24.057,4.87,3.571
31151,Nebraska,Saline County,14325,50932,36,8783,802,379,3463,72,95,959,785,174,916,808,108,611,438,173,637,505,132,13.446,4.822,2.743
31153,Nebraska,Sarpy County,175188,75752,34.2,111217,28689,15218,44463,1157,1826,7187,6131,1056,7147,6328,819,10860,9339,1521,11314,10416,898,39.479,6.709,4.107
31173,Nebraska,Thurston County,7055,44701,28.1,3830,413,200,1284,18,38,305,136,169,347,174,173,398,214,184,353,192,161,16.005,4.361,2.96
31177,Nebraska,Washington County,20414,66485,41.2,13730,3100,1127,6223,171,349,764,672,92,804,767,37,977,901,76,874,813,61,30.787,8.356,5.608
31015,Nebraska,Boyd County,2049,48750,52.1,1516,247,59,740,13,12,28,25,3,35,35,0,93,78,15,92,74,18,20.185,3.378,1.622
31031,Nebraska,Cherry County,5792,53226,43.8,4142,593,238,1639,64,53,225,211,14,193,156,37,274,273,1,295,238,57,20.063,7.138,3.234
31053,Nebraska,Dodge County,36576,51748,39.1,24593,3076,1601,9647,289,231,1594,1223,371,1561,1214,347,1886,1347,539,1923,1589,334,19.018,5.39,2.395
31059,Nebraska,Fillmore County,5603,56750,47.5,4053,571,206,1831,0,51,207,186,21,209,197,12,239,211,28,260,194,66,19.171,2.785,2.785
32001,Nevada,Churchill County,24022,46914,38.9,16340,2048,942,6261,311,472,922,671,251,977,675,302,1286,1041,245,1245,1045,200,18.299,12.506,7.539
32005,Nevada,Douglas County,47632,61176,50.8,36100,6139,3670,14143,479,1225,1501,1021,480,1447,1070,377,2011,1535,476,1981,1639,342,27.172,12.048,8.662
32015,Nevada,Lander County,5887,79865,37.8,3897,275,242,1776,0,0,246,230,16,163,152,11,351,284,67,324,302,22,13.267,0,0
32027,Nevada,Pershing County,6661,52308,43.1,5137,381,322,1415,3,87,88,62,26,103,84,19,374,205,169,250,179,71,13.685,6.36,6.148
32009,Nevada,Esmeralda County,1102,39405,48,818,110,27,269,4,0,63,44,19,67,2,65,30,14,16,36,28,8,16.748,1.487,0
32011,Nevada,Eureka County,1728,67159,47.3,1265,135,36,528,0,8,42,27,15,17,17,0,81,45,36,36,36,0,13.518,1.515,1.515
32013,Nevada,Humboldt County,17088,69324,35.6,10965,1009,661,4812,126,159,557,363,194,561,309,252,1162,932,230,947,648,299,15.23,5.923,3.304
32021,Nevada,Mineral County,4471,39375,46.7,3290,303,158,1210,21,72,115,76,39,151,133,18,296,208,88,318,194,124,14.012,7.686,5.95
32033,Nevada,White Pine County,9858,60358,39.4,7022,693,331,2551,39,70,178,121,57,198,182,16,362,311,51,420,370,50,14.583,4.273,2.744
32007,Nevada,Elko County,52377,76178,34.1,33076,3848,1990,12627,232,430,2346,2036,310,2203,1879,324,3712,3118,594,3227,2472,755,17.65,5.243,3.405
32017,Nevada,Lincoln County,5203,52971,41.6,3643,510,282,1336,72,51,203,130,73,162,147,15,122,122,0,213,201,12,21.74,9.207,3.817
32023,Nevada,Nye County,43296,44225,51.6,33362,2766,1060,12529,511,788,1364,1050,314,1257,1040,217,1888,1108,780,1454,1233,221,11.468,10.368,6.289
32029,Nevada,Storey County,3891,63607,54.7,3228,531,208,1380,56,109,67,22,45,101,93,8,165,116,49,112,112,0,22.893,11.957,7.899
32031,Nevada,Washoe County,445551,58595,38,305049,57226,33654,100137,4019,7780,21844,17299,4545,21055,17833,3222,29189,22599,6590,28137,23201,4936,29.792,11.783,7.769
32003,Nevada,Clark County,2112436,54882,36.9,1428870,222051,110702,395201,18114,34863,93755,70472,23283,92789,74587,18202,135980,97210,38770,138720,109123,29597,23.288,13.405,8.822
32510,Nevada,Carson City,54219,49341,43,38664,5006,3334,12191,544,911,2204,1766,438,2036,1719,317,3051,2362,689,2613,2312,301,21.57,11.935,7.473
32019,Nevada,Lyon County,52303,50920,43.8,37297,3580,1891,14248,557,1107,1656,1291,365,1648,1367,281,2745,2174,571,2661,2159,502,14.669,11.679,7.77
33005,New Hampshire,Cheshire County,76109,60148,42.5,52603,10363,6776,21453,867,1392,4453,3565,888,4218,3887,331,3862,2794,1068,3877,3220,657,32.582,10.53,6.489
33013,New Hampshire,Merrimack County,147958,69856,42.8,104448,22026,14696,40616,1729,2586,6768,5832,936,6930,6061,869,7015,5576,1439,7179,6070,1109,35.158,10.624,6.367
33009,New Hampshire,Grafton County,89280,61036,42.9,62303,12183,12314,23802,907,1288,5976,5372,604,5136,4366,770,4698,3913,785,4780,4240,540,39.319,9.222,5.411
33015,New Hampshire,Rockingham County,302479,85619,44.1,217737,55341,33019,92025,3884,6168,11366,10138,1228,11119,10187,932,15425,13236,2189,14885,13302,1583,40.581,10.923,6.703
33001,New Hampshire,Belknap County,60383,65834,46.7,44469,8666,5327,18619,700,1430,2235,1817,418,2266,1994,272,2752,2049,703,2727,2140,587,31.467,11.44,7.68
33019,New Hampshire,Sullivan County,43073,59419,46.1,31540,5232,2950,13054,601,1009,1759,1380,379,1520,1239,281,1900,1520,380,1905,1584,321,25.942,12.333,7.729
33011,New Hampshire,Hillsborough County,406371,75777,40.5,283506,66236,37335,104138,4864,7365,18697,15233,3464,17317,14788,2529,23505,19251,4254,22787,20076,2711,36.532,11.743,7.072
33017,New Hampshire,Strafford County,126552,67805,37,81763,18165,11009,31845,1501,2064,8839,7711,1128,10099,9235,864,6756,5780,976,6562,5657,905,35.681,11.195,6.481
33007,New Hampshire,Coos County,32119,45386,48,24528,3033,1444,9882,312,641,1247,864,383,994,877,117,1300,1070,230,1217,1006,211,18.253,9.644,6.487
33003,New Hampshire,Carroll County,47524,58139,51.4,36574,7979,4464,16870,654,1195,1442,915,527,1342,1141,201,1871,1406,465,1879,1640,239,34.021,10.96,7.084
34025,New Jersey,Monmouth County,627551,91807,42.8,436169,115874,76020,171560,8115,18625,26684,23269,3415,25665,22727,2938,28995,22315,6680,29112,24423,4689,43.995,15.586,10.856
34021,New Jersey,Mercer County,373362,77027,38.6,250034,53953,49772,83188,3444,7564,20682,17509,3173,20224,17967,2257,20256,14753,5503,20264,16949,3315,41.484,13.233,9.093
34037,New Jersey,Sussex County,143570,89238,44.1,101164,23533,11218,44342,2448,4227,5961,5233,728,5838,5377,461,6685,5365,1320,5932,5281,651,34.351,15.053,9.533
34011,New Jersey,Cumberland County,154952,50000,36.8,104613,10464,4549,32245,1442,3306,6566,4977,1589,6474,5404,1070,8666,5892,2774,8489,6494,1995,14.351,14.725,10.253
34035,New Jersey,Somerset County,333316,106046,41.3,230407,66537,55850,88188,3856,8186,13059,11658,1401,12776,11555,1221,16261,13720,2541,16114,14410,1704,53.118,13.655,9.282
34013,New Jersey,Essex County,800401,57365,37.3,534516,109961,71957,124852,6571,18455,36717,27824,8893,37738,30633,7105,45104,30699,14405,49536,38939,10597,34.034,20.045,14.782
34029,New Jersey,Ocean County,589699,65771,42.9,406087,76806,38473,178570,8908,18942,23171,19128,4043,22382,19644,2738,28015,21893,6122,27700,23364,4336,28.388,15.596,10.608
34001,New Jersey,Atlantic County,272926,57514,41.1,187294,33494,16288,67845,3887,9543,13080,10520,2560,12357,10676,1681,13989,10000,3989,14500,11935,2565,26.58,19.795,14.066
34015,New Jersey,Gloucester County,291372,81489,39.9,198621,40959,20597,83431,3795,6555,13462,11802,1660,12502,11386,1116,15854,13374,2480,16007,14664,1343,30.992,12.405,7.857
34023,New Jersey,Middlesex County,837288,83133,38.1,572917,142318,98366,180484,8565,17395,41326,34973,6353,39908,35434,4474,51079,41271,9808,51974,45075,6899,42.01,14.384,9.638
34033,New Jersey,Salem County,63776,63934,41.9,44330,6440,2878,17153,524,1359,2714,2291,423,2672,2510,162,3075,2366,709,3216,2803,413,21.02,10.978,7.923
34031,New Jersey,Passaic County,510563,63339,36.7,336045,60664,30103,86901,5536,12066,25498,18486,7012,26114,20891,5223,29819,20872,8947,29925,24059,5866,27.01,20.255,13.885
34009,New Jersey,Cape May County,94549,62332,48.7,69911,14444,7443,30900,1720,3374,3772,3219,553,3385,3046,339,4033,3263,770,4049,3679,370,31.307,16.485,10.919
34007,New Jersey,Camden County,510996,65037,38.5,348322,68485,39815,125008,5608,11741,22963,18895,4068,22889,20413,2476,30247,23259,6988,31065,26752,4313,31.092,13.878,9.392
34003,New Jersey,Bergen County,937920,91572,41.6,659670,196349,119571,218066,11100,25170,38191,32265,5926,36244,31587,4657,48574,38187,10387,49608,42051,7557,47.891,16.633,11.542
34039,New Jersey,Union County,557320,73376,38.3,377040,77535,50914,110762,6008,14036,25429,18638,6791,23829,18809,5020,31519,22676,8843,32181,25539,6642,34.068,18.096,12.672
34041,New Jersey,Warren County,107088,75500,43.5,75330,15509,8335,29523,1514,2557,4525,3865,660,4389,3981,408,5286,4237,1049,4943,4333,610,31.653,13.789,8.661
34017,New Jersey,Hudson County,679756,62681,34.9,481845,118853,70614,79116,5014,10863,35233,25655,9578,31798,24518,7280,63951,48272,15679,62974,51962,11012,39.321,20.068,13.73
34019,New Jersey,Hunterdon County,125717,110969,45.9,88545,26800,18121,39185,1641,3021,4419,4196,223,4083,3914,169,4394,3715,679,4523,4185,338,50.732,11.897,7.71
34005,New Jersey,Burlington County,449192,82839,41.4,313495,74439,40856,125557,6218,10941,19768,17690,2078,17540,16264,1276,22053,18102,3951,23439,21224,2215,36.777,13.666,8.714
34027,New Jersey,Morris County,498847,107034,42.3,347344,106554,76125,135197,6235,11926,20383,18419,1964,19694,18064,1630,24266,20519,3747,23403,20525,2878,52.593,13.433,8.821
35045,New Mexico,San Juan County,128221,49686,34.6,81304,6752,5081,30647,683,1351,6164,3935,2229,5749,4390,1359,7718,5044,2674,7836,6245,1591,14.554,6.637,4.408
35037,New Mexico,Quay County,8447,26663,46.1,5761,485,402,2115,33,118,450,373,77,323,321,2,348,236,112,280,276,4,15.397,7.139,5.579
35027,New Mexico,Lincoln County,19497,42145,50.9,14662,2907,1438,6190,206,578,510,384,126,675,569,106,775,586,189,794,630,164,29.634,12.666,9.338
35005,New Mexico,Chaves County,65454,42177,35.3,41186,5149,2670,15870,495,919,3300,2230,1070,2806,2334,472,3406,2489,917,3833,3004,829,18.985,8.91,5.791
35025,New Mexico,Lea County,69505,59285,31.7,41617,3292,2172,14999,271,532,3474,2462,1012,3332,2587,745,4445,3287,1158,4104,3082,1022,13.129,5.354,3.547
35049,New Mexico,Santa Fe County,147514,57945,45.3,108259,22812,22042,43346,1789,4377,5359,4180,1179,5253,4160,1093,7153,4704,2449,7454,5636,1818,41.432,14.225,10.098
35059,New Mexico,Union County,4216,38240,40.2,2989,296,180,937,33,23,182,131,51,126,124,2,202,165,37,143,110,33,15.925,5.977,2.455
35051,New Mexico,Sierra County,11254,29690,55.9,8689,1121,548,4019,86,298,367,254,113,300,248,52,390,351,39,338,263,75,19.208,9.555,7.415
35053,New Mexico,Socorro County,17098,34008,40,10962,1309,831,3573,41,105,1307,1103,204,623,589,34,799,626,173,632,605,27,19.522,4.086,2.939
35041,New Mexico,Roosevelt County,19313,35928,29.7,11004,1488,1206,4358,96,344,1547,1229,318,1725,1508,217,985,720,265,959,760,199,24.482,10.096,7.894
35028,New Mexico,Los Alamos County,18031,110190,43,12704,3196,5119,5543,25,120,462,391,71,452,372,80,986,794,192,864,839,25,65.452,2.616,2.165
35039,New Mexico,Rio Arriba County,39455,33422,40.7,26604,3186,1725,9848,214,446,1628,1249,379,1558,1259,299,1998,1218,780,2054,1705,349,18.46,6.702,4.529
35047,New Mexico,San Miguel County,28203,29168,42.9,19478,1979,1834,7770,161,622,1285,975,310,1124,861,263,1578,1091,487,1383,1290,93,19.576,10.077,8.005
35035,New Mexico,Otero County,65130,43533,35.6,42409,4319,3447,15169,434,819,3026,2259,767,2581,2148,433,3147,2441,706,3823,3167,656,18.312,8.26,5.399
35061,New Mexico,Valencia County,75845,43428,39,50564,5302,2957,21718,825,2225,3201,2307,894,3060,2318,742,3845,2822,1023,3714,3159,555,16.334,14.044,10.245
35057,New Mexico,Torrance County,15534,35543,44,10996,1299,646,4487,190,454,592,438,154,523,466,57,584,419,165,744,666,78,17.688,14.353,10.118
35001,New Mexico,Bernalillo County,674855,50386,37.1,458214,84115,69078,165608,5939,14436,32250,24274,7976,32129,25931,6198,44777,35335,9442,44295,37466,6829,33.433,12.303,8.717
35006,New Mexico,Cibola County,27049,36089,36.4,17996,1548,679,6450,82,224,1226,923,303,1111,858,253,1517,1170,347,1359,1136,223,12.375,4.744,3.473
35011,New Mexico,De Baca County,2016,31439,42.6,1371,78,64,443,2,15,14,12,2,69,69,0,79,18,61,77,72,5,10.357,3.837,3.386
35019,New Mexico,Guadalupe County,4426,26060,41.7,3418,262,185,833,34,18,35,23,12,109,109,0,212,212,0,261,215,46,13.078,6.242,2.161
35003,New Mexico,Catron County,3547,42047,60.2,2958,507,257,1331,5,36,47,47,0,23,23,0,137,87,50,57,53,4,25.828,3.08,2.705
35023,New Mexico,Hidalgo County,4446,31829,42.6,3115,294,154,1282,40,144,76,47,29,145,130,15,345,318,27,159,123,36,14.382,14.353,11.232
35029,New Mexico,Luna County,24319,27602,39,15549,1342,856,5612,157,389,1128,776,352,1106,826,280,1285,803,482,1143,905,238,14.136,9.729,6.932
35031,New Mexico,McKinley County,72849,30336,31.6,43373,2572,2125,14131,169,612,4079,2302,1777,3961,2800,1161,4376,2371,2005,4504,3264,1240,10.829,5.527,4.331
35043,New Mexico,Sandoval County,138815,60345,39.6,93967,16453,11796,39815,1697,2914,5387,4084,1303,5278,4227,1051,7324,5524,1800,7615,6446,1169,30.063,11.581,7.319
35055,New Mexico,Taos County,32809,35314,47.7,24305,3897,2839,9366,176,786,1282,861,421,1155,870,285,1328,815,513,1396,1093,303,27.714,10.271,8.392
35017,New Mexico,Grant County,28382,40470,45.9,20168,3044,2401,8585,256,499,1144,939,205,1144,1079,65,1281,1163,118,1289,1194,95,26.998,8.794,5.812
35009,New Mexico,Curry County,50283,41941,30.8,30517,3952,2121,10664,257,1016,3049,2154,895,2241,1815,426,3213,2219,994,3558,2980,578,19.9,11.937,9.527
35007,New Mexico,Colfax County,12522,33042,48.8,9223,1194,695,3768,102,182,413,320,93,434,409,25,578,429,149,456,318,138,20.481,7.537,4.83
35015,New Mexico,Eddy County,56793,60703,35.9,36678,3602,2338,15012,245,585,2773,2116,657,2460,2062,398,3635,3037,598,3279,2797,482,16.195,5.529,3.897
35021,New Mexico,Harding County,546,35096,58.4,437,88,17,149,1,1,1,1,0,0,0,0,20,15,5,11,10,1,24.027,1.342,0.671
35033,New Mexico,Mora County,4605,26644,47,3044,210,177,1153,7,59,378,283,95,275,147,128,168,158,10,112,83,29,12.714,5.724,5.117
35013,New Mexico,Doña Ana County,213849,39114,32.9,128109,20740,14424,48139,1421,3371,15127,11256,3871,14525,11891,2634,11336,8522,2814,11761,9010,2751,27.449,9.955,7.003
36095,New York,Schoharie County,31611,51842,44.1,22191,2825,1970,9471,328,703,1719,1495,224,1628,1558,70,1442,1216,226,1377,1261,116,21.608,10.886,7.423
36005,New York,Bronx County,1455846,36593,33.6,927374,115670,63879,97658,5522,14992,82209,65297,16912,81848,70710,11138,94831,66196,28635,105940,88907,17033,19.361,21.006,15.352
36067,New York,Onondaga County,467669,57271,38.8,316513,62078,48689,120606,3342,5889,23239,20533,2706,24062,22378,1684,27066,23093,3973,27838,25542,2296,34.996,7.654,4.883
36035,New York,Fulton County,53955,48033,43.4,38651,3778,3052,16085,360,972,2156,1775,381,1941,1730,211,2901,2388,513,2903,2551,352,17.671,8.281,6.043
36019,New York,Clinton County,81224,52759,39.4,55125,6200,5854,21542,564,1175,4737,4258,479,5132,4768,364,4008,3448,560,3730,3481,249,21.867,8.073,5.454
36099,New York,Seneca County,34843,51601,42.2,24870,2962,2134,9912,339,389,1323,1096,227,1247,991,256,1732,1344,388,1755,1582,173,20.491,7.345,3.925
36083,New York,Rensselaer County,159800,63166,39.9,110822,18877,14169,40878,1438,2343,8830,8099,731,7147,6713,434,9492,8121,1371,10010,9209,801,29.819,9.249,5.732
36079,New York,Putnam County,99464,99608,43.8,70373,15619,11507,28101,1498,3276,4418,4054,364,4044,3730,314,4683,3887,796,4277,3783,494,38.546,16.989,11.658
36033,New York,Franklin County,51054,50733,40.5,35862,3240,3451,13820,220,775,2294,1927,367,2086,1846,240,2451,2085,366,2209,2039,170,18.658,7.2,5.608
36043,New York,Herkimer County,62943,49077,43.7,43979,5258,3850,18053,475,805,2927,2416,511,2730,2522,208,3056,2559,497,3016,2811,205,20.71,7.09,4.459
36069,New York,Ontario County,109491,61710,43.4,76354,14319,11395,32389,928,1658,5088,4523,565,4861,4364,497,5199,4333,866,5113,4664,449,33.677,7.984,5.119
36081,New York,Queens County,2339280,62008,38.3,1665576,325374,187932,346041,18265,51702,108373,87430,20943,109378,94529,14849,170080,125440,44640,170532,139218,31314,30.819,20.219,14.941
36101,New York,Steuben County,97539,50157,42.4,68162,7885,7497,28956,651,1228,3954,3346,608,3716,3409,307,5118,4060,1058,4888,4452,436,22.567,6.489,4.241
36041,New York,Hamilton County,4646,55587,53.7,3604,313,409,927,19,58,210,165,45,125,111,14,116,70,46,148,124,24,20.033,8.306,6.257
36115,New York,Washington County,62183,52527,43.6,44765,5207,3649,17431,644,1211,2385,2051,334,2245,2015,230,3045,2321,724,2921,2727,194,19.783,10.642,6.947
36013,New York,Chautauqua County,130846,44304,42.3,90242,10576,8570,37098,907,1769,6350,5524,826,6052,5506,546,6471,5544,927,6620,5951,669,21.216,7.213,4.768
36047,New York,Kings County,2635121,52782,34.8,1789355,380135,249155,283752,15863,47989,126642,104341,22301,132100,116403,15697,205434,162796,42638,221881,192745,29136,35.169,22.503,16.912
36061,New York,New York County,1653877,79781,37.1,1259137,397987,366162,182453,3857,11904,81793,72564,9229,98037,90963,7074,158556,138654,19902,172337,158511,13826,60.688,8.638,6.524
36107,New York,Tioga County,49322,57153,44,34772,5443,3148,15422,418,593,2028,1811,217,1872,1715,157,2311,1997,314,2386,2206,180,24.707,6.556,3.845
36011,New York,Cayuga County,78319,54664,42.5,55476,7518,4935,22255,612,1358,3470,3010,460,2906,2649,257,3810,3100,710,4020,3680,340,22.448,8.852,6.102
36073,New York,Orleans County,41584,49223,42.8,29704,2874,1842,12166,255,670,1847,1602,245,1626,1388,238,2080,1783,297,1960,1796,164,15.877,7.603,5.507
36091,New York,Saratoga County,226632,77548,42.3,160285,37413,27322,66624,2074,3666,8989,8202,787,8924,8399,525,11786,10552,1234,11436,10743,693,40.387,8.616,5.503
36087,New York,Rockland County,325027,88571,36.2,204647,44992,37762,68822,4326,9121,15095,13265,1830,14607,13051,1556,16847,13325,3522,16048,14005,2043,40.437,19.539,13.253
36021,New York,Columbia County,61481,61093,47.4,45715,7112,6663,18429,692,1340,2481,2244,237,2102,1882,220,2737,2310,427,2885,2571,314,30.132,11.026,7.271
36049,New York,Lewis County,26845,51475,41.8,18363,1664,1322,7987,136,402,1079,854,225,1109,984,125,1382,1171,211,1261,1163,98,16.261,6.736,5.033
36063,New York,Niagara County,212675,51656,43,150502,20569,14801,62888,1700,3186,9545,8580,965,9510,8911,599,11192,9426,1766,11383,10440,943,23.501,7.769,5.066
36119,New York,Westchester County,975321,89968,40.6,668102,159656,159217,212731,10349,22706,41652,35369,6283,41369,37014,4355,49191,37909,11282,49494,42293,7201,47.728,15.538,10.674
36025,New York,Delaware County,45950,47921,47,32972,3997,3135,14008,359,801,2499,2163,336,2102,1904,198,1945,1606,339,1894,1583,311,21.63,8.281,5.718
36031,New York,Essex County,38233,55294,46.7,28866,4186,3518,11600,231,589,1466,1230,236,1175,1131,44,1683,1410,273,1751,1604,147,26.689,7.069,5.078
36057,New York,Montgomery County,49500,47449,41.1,34126,3460,2358,13565,440,655,2138,1865,273,1853,1663,190,2629,2044,585,2844,2494,350,17.049,8.072,4.829
36059,New York,Nassau County,1363069,105744,41.5,942504,229392,188711,357982,17806,41903,61787,55052,6735,59251,54907,4344,68777,56770,12007,68518,60824,7694,44.361,16.679,11.705
36085,New York,Richmond County,475948,76244,39.9,328506,62620,42865,115428,6308,16494,21847,19709,2138,21963,20476,1487,28143,23526,4617,27580,24918,2662,32.111,19.754,14.289
36089,New York,St. Lawrence County,110817,48330,38,72131,8335,8338,30189,910,1726,7536,6687,849,6566,6124,442,5444,4639,805,5508,5026,482,23.115,8.732,5.717
36097,New York,Schuyler County,18112,47810,45.7,13177,1568,1341,5688,115,414,733,609,124,652,592,60,815,648,167,827,713,114,22.076,9.3,7.278
36109,New York,Tompkins County,104415,56200,30.4,60092,13726,17889,21630,731,1285,12833,12348,485,12362,11719,643,6079,5337,742,5770,5230,540,52.611,9.32,5.941
36113,New York,Warren County,64701,60222,46.2,47642,7426,6529,19605,723,1309,2672,2310,362,2470,2181,289,3213,2822,391,3312,3098,214,29.291,10.365,6.677
36017,New York,Chenango County,48763,48567,44.4,34561,3571,2874,15265,392,679,1877,1649,228,1943,1837,106,2406,2057,349,2240,2093,147,18.648,7.016,4.448
36023,New York,Cortland County,48334,52451,36.2,30199,4460,3397,11598,199,490,3536,3354,182,4349,4180,169,2403,2020,383,2440,2278,162,26.017,5.941,4.225
36027,New York,Dutchess County,295685,75585,41.8,204168,38896,31746,74264,3976,7280,15319,14025,1294,15652,14832,820,14533,11968,2565,13848,12338,1510,34.6,15.157,9.803
36045,New York,Jefferson County,116567,50322,31.9,73008,9044,6609,24012,729,1187,5110,4226,884,5366,5002,364,6276,5329,947,7496,6854,642,21.44,7.979,4.943
36055,New York,Monroe County,748680,55272,38.6,510165,105288,83730,191781,5770,11888,39307,35816,3491,39700,37181,2519,44633,38800,5833,46145,43426,2719,37.05,9.207,6.199
36065,New York,Oneida County,232324,51316,41,159917,22777,15433,60271,1619,3070,11525,10010,1515,10376,9555,821,11697,9831,1866,12373,11530,843,23.894,7.78,5.094
36103,New York,Suffolk County,1497595,92838,41,1030141,196946,163250,393065,22983,50372,70814,62076,8738,65747,59635,6112,76386,62556,13830,74337,65054,9283,34.966,18.662,12.815
36111,New York,Ulster County,180129,61652,43.6,129659,22291,18400,48343,2051,4598,8404,7377,1027,8466,7587,879,9228,7302,1926,9069,7908,1161,31.383,13.754,9.511
36121,New York,Wyoming County,40886,55459,41.8,29320,2832,1688,11897,266,617,1486,1295,191,1479,1426,53,2067,1756,311,1903,1742,161,15.416,7.422,5.186
36015,New York,Chemung County,86883,51251,41.2,60124,8149,6961,23609,561,1067,3527,3187,340,3858,3464,394,4000,3472,528,4567,4142,425,25.131,6.896,4.519
36051,New York,Livingston County,64373,53654,40.4,42717,5614,4499,17888,519,1058,3989,3643,346,4733,4508,225,2699,2432,267,2783,2604,179,23.674,8.816,5.915
36075,New York,Oswego County,119833,51755,39.8,80201,8412,6291,33302,970,1785,6734,6110,624,6463,6144,319,6451,5429,1022,6041,5551,490,18.333,8.273,5.36
36077,New York,Otsego County,60750,51254,42,40004,6124,5711,17553,476,1154,4397,3888,509,5135,4681,454,2647,2271,376,2493,2315,178,29.585,9.286,6.574
36039,New York,Greene County,47791,53214,45.6,35151,4380,3363,12960,453,1065,1916,1757,159,1660,1514,146,2255,2047,208,2133,1935,198,22.028,11.713,8.218
36117,New York,Wayne County,91442,53693,43.6,63889,8181,5704,28109,890,1416,3710,3153,557,3492,3197,295,4426,3770,656,4489,4164,325,21.733,8.204,5.038
36001,New York,Albany County,308580,62293,37.8,204833,43162,39895,71274,2208,3713,21207,18974,2233,21989,20569,1420,17845,15519,2326,17854,16836,1018,40.549,8.307,5.209
36003,New York,Allegany County,47400,45359,38.6,30331,3012,2991,13463,321,649,3341,2971,370,2934,2705,229,2152,1829,323,2136,1888,248,19.792,7.205,4.821
36007,New York,Broome County,196124,49064,39.6,129802,20371,16037,51769,1113,2597,13210,11668,1542,12672,11973,699,9820,8269,1551,9632,9141,491,28.049,7.166,5.017
36009,New York,Cattaraugus County,78175,45571,41.7,53201,5702,4366,22617,516,1018,3421,2883,538,3465,3109,356,3788,3084,704,3782,3271,511,18.924,6.783,4.501
36029,New York,Erie County,923995,54006,40.3,642871,117778,93578,251212,6838,12575,45238,41503,3735,44996,42734,2262,55530,48442,7088,56082,52565,3517,32.877,7.728,5.006
36053,New York,Madison County,71760,58365,41.3,47707,7427,5477,19985,575,1135,4217,3787,430,4535,4252,283,3322,2800,522,3145,2995,150,27.048,8.556,5.679
36093,New York,Schenectady County,155239,61315,39.8,106739,18515,14366,36519,1370,2111,7558,6754,804,7152,6575,577,8486,7295,1191,8869,8113,756,30.805,9.532,5.781
36105,New York,Sullivan County,75783,53877,42.6,53264,7141,5297,18521,780,1531,3165,2693,472,2729,2420,309,3976,2814,1162,3962,3516,446,23.352,12.478,8.266
36037,New York,Genesee County,58537,54033,43.2,41240,5226,3616,17369,403,879,2637,2239,398,2580,2292,288,3209,2881,328,2895,2732,163,21.44,7.381,5.061
36123,New York,Yates County,25083,51758,41.7,16613,2220,1755,7196,173,460,1129,860,269,1438,1014,424,1166,826,340,1148,853,295,23.927,8.797,6.392
36071,New York,Orange County,378174,75146,36.9,240447,41214,29772,86449,4852,9342,19189,16974,2215,16246,14966,1280,18327,14752,3575,18830,17194,1636,29.523,16.419,10.806
37165,North Carolina,Scotland County,35445,32739,39.3,23608,2424,1318,8235,260,580,1659,1269,390,1772,1433,339,1309,896,413,1667,1354,313,15.851,10.2,7.043
37189,North Carolina,Watauga County,53421,41541,30.6,30171,7338,5233,11976,312,667,7520,6980,540,6837,6328,509,2546,1974,572,2284,1740,544,41.666,8.175,5.569
37083,North Carolina,Halifax County,52300,33573,42.7,36513,3607,1498,13388,393,1080,2232,1442,790,2329,1774,555,2408,1718,690,2534,2050,484,13.981,11.002,8.067
37001,North Carolina,Alamance County,157844,44281,39.7,106443,16342,7997,41213,1417,2754,7078,5468,1610,7738,6034,1704,8059,6008,2051,8743,6544,2199,22.866,10.121,6.682
37177,North Carolina,Tyrrell County,4090,32411,47.1,3213,152,93,1163,65,97,178,113,65,90,65,25,81,62,19,130,62,68,7.625,13.929,8.34
37079,North Carolina,Greene County,21059,36989,40.4,14841,1083,366,5094,179,349,937,623,314,635,506,129,1006,634,372,913,627,286,9.763,10.365,6.851
37087,North Carolina,Haywood County,59854,45538,47.5,44811,6564,4330,18861,560,1326,1988,1373,615,2125,1444,681,2932,1940,992,2802,2378,424,24.311,9.999,7.03
37121,North Carolina,Mitchell County,15155,42534,47.1,11205,1344,683,5079,194,326,475,411,64,527,419,108,787,500,287,667,489,178,18.09,10.238,6.419
37041,North Carolina,Chowan County,14370,41979,44.7,10492,1257,732,4310,332,332,383,241,142,340,285,55,687,403,284,962,651,311,18.957,15.406,7.703
37005,North Carolina,Alleghany County,10935,38944,49.2,8076,949,561,3558,172,300,450,213,237,388,203,185,295,205,90,373,260,113,18.697,13.266,8.432
37027,North Carolina,Caldwell County,81805,40735,44.1,58549,5765,2916,23032,655,1202,3209,2181,1028,3116,2171,945,3686,2345,1341,3766,2618,1148,14.827,8.063,5.219
37035,North Carolina,Catawba County,156182,48649,41.2,107371,15892,7173,41741,1329,1946,6342,4708,1634,6510,5293,1217,7729,5490,2239,7915,6055,1860,21.482,7.846,4.662
37045,North Carolina,Cleveland County,97038,40002,41.7,66333,6464,4504,25455,689,1727,4634,3269,1365,4422,3725,697,4384,2784,1600,4941,3761,1180,16.535,9.491,6.785
37049,North Carolina,Craven County,103374,49391,36.2,67131,10303,6016,25669,996,1922,3974,2973,1001,4926,4145,781,4700,3264,1436,5632,4260,1372,24.309,11.368,7.488
37065,North Carolina,Edgecombe County,54032,32929,40.3,36717,2692,1572,12674,522,1116,2147,1412,735,2506,1868,638,2639,1580,1059,2994,2396,598,11.613,12.924,8.805
37077,North Carolina,Granville County,58503,52089,42.5,40925,5934,2642,15367,594,1094,2128,1733,395,2385,2011,374,2906,2304,602,2629,2340,289,20.955,10.985,7.119
37085,North Carolina,Harnett County,128753,50323,33.9,82137,11267,5429,29075,1103,2071,5324,4070,1254,6025,4914,1111,6868,4518,2350,8573,6847,1726,20.327,10.917,7.123
37093,North Carolina,Hoke County,52571,45713,31.9,33360,4381,1713,11637,462,984,1876,1439,437,1956,1487,469,2907,1962,945,4394,3486,908,18.267,12.426,8.456
37089,North Carolina,Henderson County,112156,50454,46.9,82961,16894,8992,34555,1272,2189,3564,2466,1098,3604,2769,835,5077,3381,1696,5182,3793,1389,31.203,10.016,6.335
37095,North Carolina,Hyde County,5507,40532,42.7,3968,193,93,1400,22,55,203,201,2,171,151,20,116,97,19,179,132,47,7.208,5.5,3.929
37097,North Carolina,Iredell County,169798,55957,40.4,115647,21711,9443,45690,1600,3091,7381,5367,2014,6595,5199,1396,8355,6633,1722,8788,7031,1757,26.939,10.267,6.765
37119,North Carolina,Mecklenburg County,1034290,61695,34.9,688046,200706,102491,224217,7831,17284,47804,37432,10372,50908,42175,8733,74851,56240,18611,79160,63892,15268,44.066,11.201,7.709
37131,North Carolina,Northampton County,20426,33508,48.6,15066,1179,751,6106,195,426,799,401,398,740,530,210,763,454,309,846,679,167,12.81,10.17,6.977
37147,North Carolina,Pitt County,176484,43526,32,105532,20457,12122,35957,1209,2362,14491,12215,2276,16645,14212,2433,9814,6746,3068,11106,9112,1994,30.871,9.931,6.569
37159,North Carolina,Rowan County,138940,46978,40.1,95078,12616,4837,35274,1085,2287,6224,4570,1654,6481,5163,1318,7023,4670,2353,7132,5272,1860,18.357,9.559,6.484
37181,North Carolina,Vance County,44420,35246,40.6,29738,2575,1017,9980,584,753,2197,1571,626,1987,1468,519,1742,1293,449,2543,2272,271,12.079,13.397,7.545
37039,North Carolina,Cherokee County,27463,38115,50.8,20942,2438,1574,8965,263,602,866,644,222,788,447,341,994,560,434,1098,803,295,19.158,9.649,6.715
37053,North Carolina,Currituck County,25247,65758,42.9,17861,3022,1069,8055,405,705,880,586,294,713,591,122,1068,685,383,1258,1004,254,22.905,13.78,8.752
37179,North Carolina,Union County,222095,70858,38,140617,33350,14407,59339,2474,4299,8526,6491,2035,8621,7198,1423,9296,6825,2471,9900,8035,1865,33.962,11.414,7.245
37193,North Carolina,Wilkes County,68525,37173,44.1,48844,5288,2233,20691,650,1126,2682,1783,899,2240,1699,541,3095,2257,838,3343,2897,446,15.398,8.583,5.442
37067,North Carolina,Forsyth County,368362,48369,38.2,245413,52053,30929,90625,3255,5729,16316,12564,3752,18552,15263,3289,20018,14685,5333,22109,17708,4401,33.813,9.913,6.322
37127,North Carolina,Nash County,94125,46187,41.4,64512,8695,4403,24072,928,1509,4136,3077,1059,4102,3146,956,4397,3144,1253,4762,3652,1110,20.303,10.124,6.269
37003,North Carolina,Alexander County,37159,44523,42.8,26561,2453,1232,10382,369,458,1510,1146,364,1353,946,407,1777,1207,570,1680,1354,326,13.874,7.966,4.411
37017,North Carolina,Bladen County,34130,32396,42.8,24279,2456,1074,9913,268,792,1315,885,430,1166,900,266,1472,1064,408,1835,1363,472,14.539,10.693,7.99
37055,North Carolina,Dare County,35412,55640,46,26282,5284,2557,10598,717,1282,1165,837,328,1102,1002,100,1647,811,836,1675,925,750,29.834,18.862,12.097
37031,North Carolina,Carteret County,68699,51584,47.4,51560,8112,5630,21801,812,1763,2179,1509,670,2070,1650,420,3034,2075,959,3247,2620,627,26.652,11.811,8.087
37185,North Carolina,Warren County,20190,35443,47.2,14468,1463,817,5873,235,485,969,478,491,755,526,229,607,323,284,892,662,230,15.759,12.259,8.258
37195,North Carolina,Wilson County,81379,42095,40.4,55011,7465,2869,19391,912,1292,3445,2617,828,3669,2919,750,4135,2868,1267,4363,3354,1009,18.785,11.366,6.663
37015,North Carolina,Bertie County,19913,31287,45,14657,1155,647,5882,275,710,767,638,129,660,525,135,890,480,410,920,783,137,12.294,16.746,12.071
37073,North Carolina,Gates County,11601,52481,45,8277,794,507,3569,154,269,492,377,115,444,373,71,564,339,225,473,353,120,15.718,11.852,7.537
37075,North Carolina,Graham County,8607,36030,45,6053,536,321,2702,60,78,326,232,94,345,208,137,360,307,53,351,236,115,14.158,5.107,2.887
37117,North Carolina,Martin County,23227,35969,46,16621,1775,858,6630,167,519,975,624,351,823,556,267,983,724,259,1064,947,117,15.841,10.347,7.828
37115,North Carolina,Madison County,21347,40563,44.2,15174,2304,1631,6229,196,416,1085,955,130,875,778,97,959,723,236,1012,903,109,25.933,9.825,6.678
37137,North Carolina,Pamlico County,12803,45211,51,9824,1209,695,4040,194,211,422,229,193,351,230,121,509,338,171,597,415,182,19.381,10.025,5.223
37143,North Carolina,Perquimans County,13506,44039,48.9,10092,1390,597,4280,177,356,389,264,125,414,302,112,486,381,105,692,509,183,19.689,12.453,8.318
37149,North Carolina,Polk County,20434,48412,52.1,15648,3144,1852,6514,219,430,704,532,172,651,472,179,642,443,199,729,541,188,31.927,9.963,6.601
37151,North Carolina,Randolph County,142827,43598,41.5,98075,10713,4305,39823,1351,1978,5881,3982,1899,5737,4119,1618,7010,4765,2245,7073,5583,1490,15.313,8.359,4.967
37157,North Carolina,Rockingham County,91566,41700,44.4,65455,6665,2956,25427,960,1427,3541,2531,1010,3573,2658,915,4003,2795,1208,4395,3693,702,14.699,9.388,5.612
37169,North Carolina,Stokes County,46124,44490,45.3,33595,3585,1101,14953,316,800,1637,1298,339,1550,1219,331,2186,1517,669,2310,1691,619,13.949,7.463,5.35
37187,North Carolina,Washington County,12331,34557,43.5,8516,538,240,3164,86,226,716,558,158,599,456,143,262,134,128,563,361,202,9.136,9.861,7.143
37029,North Carolina,Camden County,10336,68327,40.8,7131,800,491,3042,111,307,325,287,38,251,194,57,407,351,56,566,472,94,18.104,13.741,10.092
37043,North Carolina,Clay County,10753,37070,50.7,8212,1168,725,3924,78,396,372,100,272,264,124,140,417,325,92,471,282,189,23.052,12.08,10.092
37051,North Carolina,Cumberland County,332766,44737,31,203986,32717,16760,63533,2714,5095,15125,10831,4294,18178,15137,3041,17329,12302,5027,22557,18916,3641,24.255,12.291,8.019
37071,North Carolina,Gaston County,214049,46626,40.1,146885,21333,8731,52730,1710,3592,9266,6951,2315,9005,7272,1733,10906,7970,2936,12119,9652,2467,20.468,10.055,6.812
37081,North Carolina,Guilford County,517197,49253,37.2,344396,77709,42647,118412,4313,8603,26157,20808,5349,28727,23936,4791,28639,20649,7990,33139,26357,6782,34.947,10.908,7.265
37099,North Carolina,Jackson County,41725,45078,37.2,26716,4455,3683,10565,227,708,3277,2697,580,3562,3139,423,2226,1422,804,2006,1580,426,30.461,8.85,6.701
37125,North Carolina,Moore County,94191,54468,44.7,67957,14770,9670,28402,809,1998,2744,2055,689,2974,2339,635,3847,2758,1089,4652,3858,794,35.964,9.883,7.035
37139,North Carolina,Pasquotank County,39546,47264,38.1,26571,3422,1987,8848,239,695,1799,1339,460,1870,1388,482,2197,1457,740,2333,1762,571,20.357,10.556,7.855
37155,North Carolina,Robeson County,134187,32407,35.9,85584,7672,3291,29859,793,1515,6775,4519,2256,6911,5461,1450,6897,4014,2883,7773,5616,2157,12.81,7.73,5.074
37167,North Carolina,Stanly County,60875,46017,42.4,42321,5068,1928,17293,585,1010,2751,2131,620,2362,1729,633,2957,2231,726,3244,2566,678,16.531,9.223,5.841
37173,North Carolina,Swain County,14208,35271,41.1,9818,1031,446,3921,144,182,657,496,161,684,404,280,749,353,396,704,498,206,15.044,8.314,4.642
37183,North Carolina,Wake County,1023811,73577,35.8,677119,217337,127784,244792,7500,13438,47414,39514,7900,46817,40300,6517,64649,50679,13970,68903,58614,10289,50.969,8.553,5.49
37199,North Carolina,Yancey County,17605,37610,46.8,13035,1613,958,5496,117,324,631,391,240,712,535,177,761,438,323,684,476,208,19.724,8.024,5.895
37007,North Carolina,Anson County,25531,38123,40.4,18081,1179,490,6267,67,427,1228,827,401,1071,922,149,1501,766,735,1218,1004,214,9.231,7.883,6.813
37037,North Carolina,Chatham County,68364,59684,46.3,49958,10683,9350,21452,538,1405,2317,1634,683,2136,1504,632,2761,1830,931,2878,1961,917,40.1,9.057,6.55
37111,North Carolina,McDowell County,45069,38776,43.3,32336,3646,1486,12804,295,701,1793,1136,657,1767,1493,274,2085,1665,420,2001,1476,525,15.871,7.779,5.475
37069,North Carolina,Franklin County,63866,48344,40.9,43826,6507,2705,17744,453,1317,2707,2058,649,2601,1927,674,3110,2162,948,3020,2402,618,21.019,9.975,7.422
37101,North Carolina,Johnston County,186308,54610,37.9,122671,19175,7393,46877,1364,2862,7217,5107,2110,6973,5202,1771,9630,6720,2910,10129,7782,2347,21.658,9.015,6.105
37103,North Carolina,Jones County,9776,37256,45.5,7224,683,340,3009,119,364,379,218,161,344,220,124,440,265,175,482,268,214,14.161,16.052,12.097
37113,North Carolina,Macon County,34160,40659,49.3,25576,3731,1951,11440,261,877,1295,664,631,1126,834,292,1385,829,556,1576,1049,527,22.216,9.948,7.666
37145,North Carolina,Person County,39240,44921,43,27663,3028,1194,11361,456,673,1585,1105,480,1624,1324,300,1640,1128,512,1867,1503,364,15.262,9.938,5.924
37019,North Carolina,Brunswick County,122586,51164,51.9,95320,17232,9458,40983,1721,3721,3444,2435,1009,3224,2547,677,4935,3039,1896,5688,3997,1691,28,13.279,9.079
37175,North Carolina,Transylvania County,33291,44559,50.6,25011,4378,3104,10726,244,749,1331,881,450,1187,722,465,1213,837,376,1544,1000,544,29.915,9.258,6.983
37009,North Carolina,Ashe County,26833,40293,47.2,20207,2669,1275,8883,235,563,845,476,369,850,621,229,1369,919,450,1222,987,235,19.518,8.983,6.338
37013,North Carolina,Beaufort County,47316,41101,45.4,33835,4287,2352,13439,539,870,1673,1190,483,1665,1326,339,2045,1473,572,2027,1542,485,19.622,10.484,6.474
37047,North Carolina,Columbus County,56589,36261,41.9,39263,3336,1589,15921,441,942,2385,1478,907,2101,1570,531,2337,1374,963,2880,1897,983,12.544,8.687,5.917
37107,North Carolina,Lenoir County,57934,37515,41.9,40180,3516,1889,13992,561,926,2331,1612,719,2212,1766,446,2848,1539,1309,2912,2175,737,13.452,10.628,6.618
37109,North Carolina,Lincoln County,80504,50782,42.7,56890,8087,3430,23896,790,1668,3248,2391,857,2932,2260,672,3670,2709,961,3942,3009,933,20.244,10.286,6.98
37123,North Carolina,Montgomery County,27445,38254,42.8,18910,1927,723,7597,271,422,1184,915,269,1037,730,307,853,610,243,1162,863,299,14.014,9.122,5.555
37133,North Carolina,Onslow County,192685,48162,26,101561,14336,6206,33135,1933,2699,9530,7987,1543,11336,9948,1388,9076,6546,2530,13019,11266,1753,20.226,13.979,8.145
37135,North Carolina,Orange County,141812,65522,34.2,87529,22592,27793,32250,996,2354,10915,10115,800,12954,12155,799,7273,5915,1358,8061,7169,892,57.564,10.388,7.299
37153,North Carolina,Richmond County,45447,33607,40.2,30544,2932,1425,12025,326,835,1910,1361,549,2249,1745,504,1917,1250,667,2124,1563,561,14.265,9.655,6.944
37161,North Carolina,Rutherford County,66523,38573,44.5,47447,5429,2767,18949,481,1199,2431,1630,801,2429,1811,618,2878,1940,938,3318,2567,751,17.274,8.866,6.328
37163,North Carolina,Sampson County,63664,37765,40.2,42499,3796,1500,16302,315,961,2638,1959,679,2754,2102,652,3188,1759,1429,3180,2179,1001,12.461,7.827,5.895
37171,North Carolina,Surry County,72315,39071,43.4,50753,5517,2850,21363,632,1275,2764,1964,800,2664,1954,710,3403,2262,1141,3299,2442,857,16.486,8.927,5.968
37197,North Carolina,Yadkin County,37825,41126,43.5,26554,2163,1031,11782,437,421,1638,1038,600,1463,1117,346,1612,1108,504,1686,1282,404,12.028,7.282,3.573
37011,North Carolina,Avery County,17535,37109,44.5,13225,1626,1051,5176,140,227,731,428,303,671,602,69,753,417,336,778,530,248,20.242,7.09,4.386
37021,North Carolina,Buncombe County,252268,48464,41.9,183555,43720,26996,67120,2065,4274,9982,7660,2322,10200,8134,2066,14727,11059,3668,16184,12824,3360,38.526,9.444,6.368
37023,North Carolina,Burke County,88898,40854,43.6,63662,6873,3736,24733,632,1536,3473,2281,1192,3527,2697,830,4219,2782,1437,4276,3238,1038,16.665,8.766,6.21
37025,North Carolina,Cabarrus County,196716,60716,37.9,129485,26125,12665,50009,1670,3156,7590,6162,1428,7731,6584,1147,10337,8057,2280,11141,9280,1861,29.957,9.65,6.311
37033,North Carolina,Caswell County,22833,39428,45.4,16611,1599,673,6998,191,602,996,717,279,843,712,131,1017,695,322,988,833,155,13.678,11.332,8.602
37059,North Carolina,Davie County,41766,53493,44.6,29709,4282,2539,12323,417,625,1354,1224,130,1418,935,483,1693,1120,573,1719,1397,322,22.959,8.456,5.072
37057,North Carolina,Davidson County,164118,45806,42.1,114428,14808,5858,46332,1262,2646,6557,4826,1731,6133,4855,1278,7872,5942,1930,8239,6630,1609,18.06,8.435,5.711
37061,North Carolina,Duplin County,59350,36679,40,39829,2972,1311,15099,411,942,2632,1618,1014,2151,1285,866,2776,1327,1449,3155,2125,1030,10.753,8.961,6.239
37063,North Carolina,Durham County,300865,56393,35,204862,51502,45297,64668,2289,3863,14939,11284,3655,16106,13335,2771,22455,17296,5159,25442,20763,4679,47.251,9.513,5.974
37091,North Carolina,Hertford County,24262,35806,42.4,16877,1671,910,5967,248,458,1154,746,408,1190,927,263,993,651,342,1035,913,122,15.293,11.832,7.676
37105,North Carolina,Lee County,59805,49272,37.9,39706,5622,2804,14600,536,988,2509,1627,882,2565,1848,717,3002,1972,1030,3357,2504,853,21.221,10.438,6.767
37129,North Carolina,New Hanover County,219866,51457,38.7,149505,38863,19301,52611,2397,5036,12858,10690,2168,14361,12958,1403,12914,9163,3751,12923,9928,2995,38.904,14.128,9.572
37141,North Carolina,Pender County,57630,49357,42.6,40493,6505,3868,16658,591,1386,2046,1619,427,1874,1339,535,2616,1770,846,2774,2253,521,25.617,11.868,8.32
37191,North Carolina,Wayne County,124496,41766,37.3,82263,11536,4675,28964,779,1699,5498,3643,1855,5354,4352,1002,6485,4771,1714,7166,5157,2009,19.706,8.555,5.866
38013,North Dakota,Burke County,2253,71667,35.7,1472,216,80,707,2,19,102,89,13,66,66,0,136,123,13,144,130,14,20.109,2.97,2.687
38061,North Dakota,Mountrail County,9986,69622,34.2,6294,1048,319,2238,22,65,558,406,152,422,324,98,756,575,181,539,392,147,21.719,3.887,2.904
38097,North Dakota,Traill County,8050,60952,41.4,5477,1013,414,2463,35,46,412,397,15,325,305,20,397,355,42,348,338,10,26.054,3.289,1.868
38105,North Dakota,Williams County,32916,89874,31.3,21218,3806,979,7975,162,190,1877,1653,224,1591,1497,94,3545,3108,437,2384,1914,470,22.552,4.414,2.382
38007,North Dakota,Billings County,983,91518,44.4,714,108,57,296,6,18,39,33,6,16,12,4,60,60,0,42,42,0,23.109,8.108,6.081
38021,North Dakota,Dickey County,5041,58357,43.6,3483,693,268,1537,12,38,232,218,14,262,214,48,277,244,33,187,174,13,27.591,3.253,2.472
38043,North Dakota,Kidder County,2457,60225,44.3,1744,277,57,800,4,5,85,62,23,90,63,27,180,141,39,94,94,0,19.151,1.125,0.625
38019,North Dakota,Cavalier County,3817,65505,50.1,2774,443,79,1465,17,27,147,140,7,122,118,4,158,126,32,128,110,18,18.818,3.003,1.843
38101,North Dakota,Ward County,69628,64159,31,43084,8861,3164,16371,344,629,4322,3792,530,3924,3582,342,5468,4624,844,4623,4166,457,27.911,5.943,3.842
38037,North Dakota,Grant County,2387,50875,52.2,1803,252,77,942,13,23,48,46,2,38,38,0,107,107,0,103,87,16,18.247,3.822,2.442
38049,North Dakota,McHenry County,5951,61788,42.8,4153,657,157,2231,23,52,211,162,49,163,149,14,308,289,19,288,260,28,19.6,3.362,2.331
38067,North Dakota,Pembina County,7050,61393,48.2,5150,833,205,2480,16,32,177,128,49,192,170,22,351,283,68,291,278,13,20.155,1.935,1.29
38091,North Dakota,Steele County,1915,65437,49.8,1411,321,40,775,3,9,70,68,2,42,42,0,85,80,5,65,59,6,25.585,1.548,1.161
38005,North Dakota,Benson County,6875,44500,30.7,3917,449,155,1439,17,19,286,171,115,307,233,74,367,240,127,345,286,59,15.42,2.502,1.32
38041,North Dakota,Hettinger County,2601,56118,47.3,1935,231,50,887,0,23,58,40,18,48,35,13,93,83,10,131,127,4,14.522,2.593,2.593
38045,North Dakota,LaMoure County,4106,57463,47.8,2938,532,149,1398,15,43,112,104,8,126,116,10,191,160,31,154,135,19,23.179,4.149,3.076
38059,North Dakota,Morton County,30059,65385,38.2,21029,4169,1317,9603,121,331,1335,1178,157,1253,1176,77,2261,2061,200,1854,1779,75,26.088,4.707,3.447
38017,North Dakota,Cass County,170620,58026,32.2,106596,29143,11729,38149,881,1395,13192,12062,1130,13435,12056,1379,13990,12318,1672,11769,10646,1123,38.343,5.966,3.657
38025,North Dakota,Dunn County,4349,68594,41.2,3035,527,170,1247,19,39,165,118,47,144,121,23,301,251,50,195,153,42,22.965,4.651,3.128
38029,North Dakota,Emmons County,3389,46581,52.1,2530,352,41,1322,7,23,76,53,23,97,95,2,105,100,5,90,88,2,15.534,2.269,1.74
38051,North Dakota,McIntosh County,2680,46012,53.5,2096,261,99,1039,5,32,60,60,0,65,65,0,127,103,24,96,88,8,17.176,3.561,3.08
38063,North Dakota,Nelson County,2971,52417,52.5,2259,372,91,1126,6,5,101,63,38,82,39,43,172,130,42,122,96,26,20.496,0.977,0.444
38077,North Dakota,Richland County,16333,60551,37.8,10565,1763,579,4849,87,86,1242,1187,55,921,799,122,842,788,54,794,720,74,22.168,3.568,1.774
38079,North Dakota,Rolette County,14657,36170,30.6,8348,1383,348,3271,25,50,679,377,302,626,386,240,748,292,456,777,529,248,20.736,2.293,1.529
38099,North Dakota,Walsh County,10920,50781,44.6,7682,963,330,3612,44,66,440,388,52,338,318,20,501,444,57,494,434,60,16.832,3.045,1.827
38001,North Dakota,Adams County,2368,54700,45.3,1686,310,152,769,0,17,109,81,28,94,79,15,124,120,4,94,82,12,27.402,2.211,2.211
38009,North Dakota,Bottineau County,6651,58767,45.2,4644,831,188,2345,80,82,390,371,19,252,176,76,293,280,13,257,242,15,21.942,6.908,3.497
38003,North Dakota,Barnes County,10971,56237,44.5,7728,1442,554,3424,90,164,450,388,62,435,421,14,555,496,59,608,556,52,25.828,7.418,4.79
38027,North Dakota,Eddy County,2321,55294,45.8,1634,277,103,742,11,18,79,40,39,78,78,0,120,101,19,76,68,8,23.256,3.908,2.426
38035,North Dakota,Grand Forks County,70130,51410,29.5,40735,9054,4811,14592,226,458,7422,6829,593,6830,6296,534,4912,4219,693,4141,3690,451,34.037,4.688,3.139
38053,North Dakota,McKenzie County,11679,79316,30.8,7225,1338,487,2131,11,30,702,518,184,486,339,147,1118,1001,117,750,569,181,25.26,1.924,1.408
38057,North Dakota,Mercer County,8637,80337,44.7,6130,999,393,3000,7,66,280,215,65,252,235,17,497,335,162,448,380,68,22.708,2.433,2.2
38055,North Dakota,McLean County,9607,63926,46.7,7026,1017,294,3503,77,120,216,189,27,226,198,28,487,450,37,429,390,39,18.659,5.624,3.426
38069,North Dakota,Pierce County,4272,45996,46.1,3061,366,118,1434,6,68,187,138,49,142,142,0,240,238,2,241,193,48,15.812,5.16,4.742
38073,North Dakota,Ransom County,5411,62524,44.4,3796,590,134,1628,42,38,233,225,8,147,141,6,229,193,36,207,205,2,19.073,4.914,2.334
38075,North Dakota,Renville County,2543,66023,39.3,1732,241,39,802,10,16,98,97,1,102,56,46,143,123,20,128,123,5,16.166,3.242,1.995
38085,North Dakota,Sioux County,4420,40795,26.9,2312,289,112,492,5,27,209,78,131,214,132,82,253,119,134,253,191,62,17.344,6.504,5.488
38011,North Dakota,Bowman County,3226,65435,42.2,2215,414,128,1062,19,40,120,107,13,150,91,59,179,179,0,133,124,9,24.47,5.556,3.766
38015,North Dakota,Burleigh County,92372,67308,36.6,62512,15842,6095,26785,466,646,4226,3893,333,4466,3931,535,6398,5519,879,5753,5295,458,35.092,4.152,2.412
38033,North Dakota,Golden Valley County,1892,44018,42.4,1253,229,47,580,7,9,54,36,18,89,76,13,89,78,11,86,76,10,22.027,2.759,1.552
38047,North Dakota,Logan County,1932,57379,52.9,1441,172,25,749,9,7,82,71,11,57,56,1,58,53,5,54,50,4,13.671,2.136,0.935
38065,North Dakota,Oliver County,1822,71500,50.1,1339,215,47,686,14,51,48,43,5,51,45,6,52,49,3,59,55,4,19.567,9.475,7.434
38095,North Dakota,Towner County,2258,54625,49.4,1643,230,67,813,4,5,50,46,4,26,19,7,76,67,9,71,57,14,18.077,1.107,0.615
38093,North Dakota,Stutsman County,21058,56088,39.7,14545,2713,780,5979,109,123,1159,1057,102,905,789,116,1130,996,134,1113,922,191,24.015,3.88,2.057
38071,North Dakota,Ramsey County,11574,55927,42.4,7925,1450,511,2990,37,95,429,347,82,408,387,21,559,424,135,598,557,41,24.744,4.415,3.177
38023,North Dakota,Divide County,2378,54223,50.9,1823,335,19,818,4,13,62,49,13,65,37,28,111,102,9,88,88,0,19.419,2.078,1.589
38031,North Dakota,Foster County,3318,59500,46.4,2396,434,133,1116,9,30,127,115,12,98,91,7,170,153,17,124,110,14,23.664,3.495,2.688
38039,North Dakota,Griggs County,2276,50272,50.9,1669,323,55,743,8,27,78,78,0,66,39,27,82,73,9,123,84,39,22.648,4.711,3.634
38081,North Dakota,Sargent County,3883,60824,46.3,2826,451,76,1353,11,17,170,152,18,126,112,14,194,184,10,177,175,2,18.648,2.069,1.256
38083,North Dakota,Sheridan County,1403,49750,52,1104,123,33,537,19,13,32,21,11,40,37,3,89,75,14,61,54,7,14.13,5.959,2.421
38087,North Dakota,Slope County,674,61250,52,503,113,22,246,5,8,25,25,0,4,2,2,33,27,6,17,17,0,26.839,5.285,3.252
38089,North Dakota,Stark County,30316,77328,34.3,19821,3454,1269,7950,126,235,1553,1341,212,1432,1106,326,2701,2342,359,2019,1784,235,23.828,4.541,2.956
38103,North Dakota,Wells County,4089,54464,51.8,3059,572,127,1592,55,26,128,124,4,120,119,1,141,137,4,163,156,7,22.851,5.088,1.633
39053,Ohio,Gallia County,30203,42002,40.6,20616,2008,1336,8688,167,560,1319,986,333,1344,1118,226,1618,1267,351,1611,1366,245,16.22,8.368,6.446
39077,Ohio,Huron County,58497,49710,39.2,39248,3552,1830,15996,452,878,2544,2092,452,2220,1981,239,3079,2437,642,3159,2837,322,13.713,8.315,5.489
39099,Ohio,Mahoning County,231857,43251,43.5,164310,25192,12953,67314,1908,3485,10072,8495,1577,9954,8939,1015,11196,9119,2077,11119,10342,777,23.215,8.012,5.177
39009,Ohio,Athens County,65563,37191,28.6,36239,4953,5760,12783,326,608,9170,8411,759,8554,7907,647,3547,2954,593,3268,2984,284,29.562,7.307,4.756
39001,Ohio,Adams County,27926,36320,42.2,18982,1507,796,7405,268,489,1068,785,283,1078,877,201,1295,973,322,1333,1234,99,12.133,10.223,6.604
39145,Ohio,Scioto County,76871,38978,39.8,53021,4507,3558,20470,454,1171,3089,2655,434,3299,2890,409,4018,3293,725,4089,3610,479,15.211,7.938,5.721
39103,Ohio,Medina County,176362,71595,41.9,121783,26703,12365,53709,1700,3052,6483,5772,711,6249,5701,548,8306,7327,979,8679,7891,788,32.08,8.848,5.682
39105,Ohio,Meigs County,23234,42105,42.8,16464,1343,790,7251,161,285,726,614,112,924,765,159,1194,961,233,1098,997,101,12.956,6.151,3.93
39159,Ohio,Union County,54688,78848,38.3,36486,7591,3645,14871,621,973,1987,1792,195,1659,1559,100,2591,2243,348,2688,2491,197,30.795,10.719,6.543
39021,Ohio,Champaign County,39005,54495,42.1,26634,2758,1531,11100,339,490,1773,1561,212,1548,1430,118,1860,1680,180,1761,1663,98,16.103,7.468,4.414
39131,Ohio,Pike County,28291,43562,41,19382,1380,1190,7585,151,309,1213,762,451,1211,958,253,1487,1142,345,1283,1189,94,13.26,6.065,4.074
39125,Ohio,Paulding County,18951,49866,41.5,13041,1235,593,5835,122,224,769,694,75,626,502,124,973,793,180,967,923,44,14.017,5.93,3.839
39057,Ohio,Greene County,164825,65032,38.1,110009,22359,20272,43261,1078,2474,8985,8177,808,9662,9030,632,9325,7838,1487,9197,8544,653,38.752,8.211,5.719
39061,Ohio,Hamilton County,808703,52389,36.9,543437,119701,77538,195236,6511,13166,39645,34200,5445,39163,35487,3676,51683,43405,8278,54166,48613,5553,36.295,10.079,6.744
39049,Ohio,Franklin County,1253507,56319,34,830824,203292,117999,266046,8908,15553,67674,57792,9882,67361,60279,7082,97787,80532,17255,100595,89926,10669,38.671,9.194,5.846
39087,Ohio,Lawrence County,61057,45466,41.5,42715,3860,2318,17036,414,751,2568,2258,310,2318,2043,275,3042,2429,613,3180,2931,249,14.463,6.838,4.408
39101,Ohio,Marion County,65483,44708,40.8,46284,3871,2371,16884,459,808,2537,2009,528,2312,2199,113,3243,2607,636,3320,2886,434,13.486,7.504,4.786
39115,Ohio,Morgan County,14773,40276,44.2,10462,924,437,4778,102,196,547,417,130,498,481,17,694,578,116,698,606,92,13.009,6.237,4.102
39157,Ohio,Tuscarawas County,92531,49460,40.9,63997,6390,3277,25837,661,1207,3619,2734,885,3538,3114,424,4597,3729,868,4651,3912,739,15.105,7.23,4.672
39169,Ohio,Wayne County,115915,54037,38.7,75948,9987,5945,31629,701,1486,5642,4538,1104,5390,4492,898,6206,4666,1540,5772,4751,1021,20.978,6.915,4.698
39175,Ohio,Wyandot County,22190,49767,41.3,15312,1642,648,6617,113,379,881,725,156,875,747,128,1063,910,153,1026,908,118,14.956,7.435,5.728
39015,Ohio,Brown County,43799,49188,41.6,30273,2753,1122,12880,582,808,1613,1420,193,1641,1488,153,2233,1757,476,2240,2013,227,12.8,10.792,6.273
39017,Ohio,Butler County,375702,62188,36.4,239423,45304,25496,93317,2538,5512,21770,18832,2938,21746,19553,2193,19353,16110,3243,19686,17313,2373,29.571,8.627,5.907
39043,Ohio,Erie County,75369,51033,44.6,53623,7607,4383,21850,536,1046,3210,2593,617,3023,2720,303,3438,2671,767,3673,3375,298,22.36,7.24,4.787
39067,Ohio,Harrison County,15397,46223,46,11048,804,399,4897,109,263,532,429,103,576,398,178,672,549,123,675,610,65,10.889,7.596,5.371
39083,Ohio,Knox County,60945,51211,38.9,39653,6087,2913,16571,492,835,3395,2803,592,3215,2844,371,2796,2446,350,3102,2718,384,22.697,8.008,5.039
39089,Ohio,Licking County,170678,59747,39.9,114884,18347,9873,46661,1361,2207,7190,6393,797,7549,7016,533,8768,7079,1689,8794,8105,689,24.564,7.647,4.73
39139,Ohio,Richland County,121533,44138,41.4,84759,9997,4564,32498,1045,1637,4471,3582,889,4516,3888,628,5679,4387,1292,5835,4848,987,17.179,8.253,5.037
39163,Ohio,Vinton County,13142,41541,41.9,9125,656,285,3711,124,153,520,411,109,457,358,99,648,537,111,631,571,60,10.312,7.464,4.123
39019,Ohio,Carroll County,27825,51748,45,19793,1423,1021,8739,205,527,972,802,170,1015,748,267,1308,1076,232,1240,1048,192,12.348,8.376,6.03
39063,Ohio,Hancock County,75508,52831,38.9,51339,8756,5174,22201,460,941,3329,2923,406,3508,3195,313,4588,4157,431,4425,4105,320,27.133,6.311,4.239
39025,Ohio,Clermont County,202166,64183,39.9,137653,25552,13412,56540,1515,3282,8615,7739,876,7871,7225,646,10830,9155,1675,10837,9710,1127,28.306,8.484,5.805
39045,Ohio,Fairfield County,151526,63424,39.2,101759,18159,8940,39788,1276,2293,6042,5361,681,5875,5451,424,7635,6419,1216,7916,7080,836,26.631,8.97,5.763
39039,Ohio,Defiance County,38311,55295,40,25859,2859,1331,11663,227,492,1865,1591,274,1608,1373,235,1977,1698,279,1933,1721,212,16.203,6.165,4.218
39071,Ohio,Highland County,43031,42333,40.3,29233,1937,1672,11743,420,876,1676,1315,361,1676,1496,180,2119,1586,533,2152,1887,265,12.346,11.036,7.46
39069,Ohio,Henry County,27463,58070,41.2,18768,1997,1270,8697,318,369,1041,906,135,961,889,72,1417,1288,129,1412,1327,85,17.407,7.899,4.243
39081,Ohio,Jefferson County,67349,43161,44.7,47783,4557,2558,19037,328,707,2891,2460,431,3151,2946,205,3060,2462,598,3183,2900,283,14.89,5.437,3.714
39133,Ohio,Portage County,162080,53816,37.8,103892,17476,11053,42710,1266,2241,11814,10269,1545,12816,11581,1235,7952,6852,1100,7707,6840,867,27.46,8.211,5.247
39137,Ohio,Putnam County,34037,61161,39.6,22550,2682,1613,10562,159,292,1298,1205,93,1251,1191,60,1736,1578,158,1765,1682,83,19.047,4.27,2.765
39013,Ohio,Belmont County,68889,46484,44.2,50566,5104,3051,20414,398,685,2570,2059,511,2410,2104,306,3399,2765,634,3260,2865,395,16.127,5.305,3.356
39027,Ohio,Clinton County,41869,49997,39.8,27907,3290,1580,10617,465,549,1910,1710,200,2009,1797,212,2053,1674,379,2017,1879,138,17.451,9.551,5.171
39047,Ohio,Fayette County,28659,44289,41.1,19567,2296,787,7284,173,481,1276,1012,264,993,928,65,1399,1217,182,1573,1391,182,15.756,8.979,6.604
39127,Ohio,Perry County,35983,46477,39.9,24368,1923,918,10004,341,484,1566,1179,387,1464,1186,278,1879,1689,190,1782,1576,206,11.659,8.247,4.838
39129,Ohio,Pickaway County,57075,60314,39.4,39415,4430,2406,14374,574,562,2377,2051,326,2212,2148,64,2726,2300,426,2651,2380,271,17.344,7.903,3.91
39091,Ohio,Logan County,45323,53051,41,30964,3295,1390,13754,466,565,1824,1320,504,1616,1335,281,2090,1788,302,2354,2178,176,15.13,7.496,4.108
39097,Ohio,Madison County,43732,62897,40.4,31005,3749,1444,10637,319,425,1567,1109,458,1394,1326,68,2156,1767,389,2026,1805,221,16.749,6.994,3.995
39153,Ohio,Summit County,541318,53291,40.8,376758,76503,42590,146403,4090,8232,24552,21528,3024,24303,21889,2414,30560,25259,5301,30890,28058,2832,31.61,8.416,5.623
39119,Ohio,Muskingum County,85933,43325,40.2,58183,5808,3343,23107,680,1087,3909,3255,654,4079,3626,453,4434,3779,655,4564,4131,433,15.728,7.647,4.704
39143,Ohio,Sandusky County,59559,50370,41.7,41001,4178,2042,16945,377,695,2410,2230,180,2497,2255,242,2990,2426,564,2755,2406,349,15.17,6.326,4.102
39149,Ohio,Shelby County,48902,57673,39.3,32291,3319,2199,13209,257,558,1795,1539,256,1783,1677,106,2649,2400,249,2450,2174,276,17.088,6.17,4.224
39161,Ohio,Van Wert County,28262,50974,41.4,19353,1999,1174,8604,187,390,1117,941,176,1163,1052,111,1404,1144,260,1363,1156,207,16.395,6.706,4.533
39167,Ohio,Washington County,60871,46021,43.8,43182,5305,2754,18744,444,691,2841,2428,413,2472,2222,250,3080,2346,734,3003,2633,370,18.663,6.055,3.687
39171,Ohio,Williams County,37061,47593,41.4,25656,2404,1334,11666,286,486,1309,1127,182,1367,1242,125,1889,1540,349,1793,1646,147,14.57,6.618,4.166
39011,Ohio,Auglaize County,45778,59516,41.1,30928,3678,2038,13903,294,534,2145,1917,228,1654,1465,189,2072,1857,215,2236,2087,149,18.482,5.956,3.841
39029,Ohio,Columbiana County,104584,45498,43.8,74871,6907,3503,30446,716,1245,4028,3064,964,3644,3184,460,5013,4106,907,4922,4439,483,13.904,6.441,4.089
39037,Ohio,Darke County,51919,50064,41.8,35392,3097,1936,15073,420,746,2001,1757,244,1765,1543,222,2415,2119,296,2485,2338,147,14.221,7.736,4.949
39123,Ohio,Ottawa County,40769,56193,48.3,30165,4255,2483,13686,434,653,1312,1084,228,1303,1072,231,1696,1334,362,1682,1489,193,22.337,7.942,4.771
39051,Ohio,Fulton County,42296,57774,40.2,28437,3208,1706,12671,334,477,1670,1370,300,1669,1493,176,2081,1724,357,2097,2010,87,17.28,6.4,3.765
39065,Ohio,Hardin County,31576,46404,35.6,19238,1663,1319,8031,224,311,2424,2074,350,2239,2000,239,1375,1178,197,1476,1317,159,15.501,6.662,3.872
39079,Ohio,Jackson County,32624,43397,40.2,22242,2380,1134,8883,239,471,1250,957,293,1382,1033,349,1909,1431,478,1798,1576,222,15.799,7.993,5.302
39095,Ohio,Lucas County,433404,44820,37.9,290699,45679,28865,107321,3396,6347,21243,17971,3272,21752,19632,2120,25127,19891,5236,26127,23278,2849,25.643,9.078,5.914
39117,Ohio,Morrow County,34935,52767,41.8,23769,2221,1021,10522,403,460,1175,914,261,1140,1077,63,1672,1439,233,1704,1524,180,13.64,8.202,4.372
39121,Ohio,Noble County,14498,42171,48.7,10992,622,538,4224,88,152,181,135,46,221,204,17,147,132,15,652,605,47,10.553,5.682,3.598
39135,Ohio,Preble County,41328,52661,42.3,28599,2779,1340,12308,416,498,1659,1443,216,1537,1385,152,2037,1752,285,2063,1811,252,14.403,7.426,4.046
39147,Ohio,Seneca County,55549,49153,39.5,37041,3588,2095,15534,395,625,2937,2676,261,2565,2422,143,2852,2429,423,2650,2469,181,15.342,6.566,4.023
39151,Ohio,Stark County,374273,50117,41.8,259199,37494,21503,103979,3343,4589,16788,14574,2214,16164,14619,1545,18888,15523,3365,19573,17887,1686,22.761,7.628,4.413
39003,Ohio,Allen County,104157,47905,38.6,69226,7294,4952,26645,626,1222,5738,4723,1015,4926,4425,501,5847,4633,1214,5171,4590,581,17.69,6.936,4.586
39031,Ohio,Coshocton County,36602,43251,41.4,25208,2310,871,10812,338,451,1376,1037,339,1341,1077,264,1843,1398,445,1829,1526,303,12.619,7.297,4.171
39033,Ohio,Crawford County,42231,41726,43,29583,2793,1545,12356,260,563,1741,1516,225,1515,1328,187,1815,1462,353,2091,1929,162,14.664,6.661,4.556
39041,Ohio,Delaware County,193024,100229,38.4,125605,43247,24309,54999,1587,3203,6573,5810,763,6325,5979,346,8427,7558,869,9325,8620,705,53.784,8.709,5.824
39055,Ohio,Geauga County,93895,77104,44.4,63761,15660,8538,30129,1160,1667,3684,2871,813,3631,2843,788,3554,3019,535,3325,2833,492,37.951,9.383,5.533
39059,Ohio,Guernsey County,39414,42744,42.4,27364,2355,1456,11505,222,581,1515,1246,269,1568,1382,186,2067,1660,407,1900,1703,197,13.927,6.98,5.05
39073,Ohio,Hocking County,28547,48073,42.7,19928,1830,972,8412,237,434,1001,689,312,1011,885,126,1414,1244,170,1443,1305,138,14.061,7.977,5.159
39085,Ohio,Lake County,229701,61137,43.5,164024,28556,16101,71096,2178,3995,9200,8106,1094,8683,7877,806,11962,10333,1629,11785,10777,1008,27.226,8.683,5.619
39107,Ohio,Mercer County,40723,57052,39.8,26909,2700,1773,12497,318,428,1780,1637,143,1508,1377,131,2016,1768,248,1940,1821,119,16.623,5.969,3.425
39141,Ohio,Ross County,77125,45792,40.5,54199,5609,3046,20075,463,1055,2562,2113,449,2757,2206,551,3558,2717,841,3717,3373,344,15.969,7.562,5.255
39023,Ohio,Clark County,135520,46275,41.2,92524,10389,6795,35995,1092,1553,6054,5018,1036,5980,5311,669,6467,5219,1248,7069,6359,710,18.572,7.348,4.314
39035,Ohio,Cuyahoga County,1257401,46720,40.4,874449,160928,114227,316372,11289,20795,56893,47352,9541,58691,52248,6443,71999,59656,12343,76529,69587,6942,31.466,10.141,6.573
39075,Ohio,Holmes County,43808,58728,30.8,25080,1525,599,9605,403,376,2217,1025,1192,1908,831,1077,2388,1233,1155,2434,1098,1336,8.469,8.11,3.915
39093,Ohio,Lorain County,305405,54987,41.5,209343,31130,18503,84684,2526,4374,12760,10982,1778,12737,11313,1424,14334,11844,2490,14770,13465,1305,23.709,8.148,5.165
39109,Ohio,Miami County,104081,54568,41.5,71937,9450,5648,28515,1019,1374,4200,3539,661,3746,3390,356,5298,4484,814,5343,4748,595,20.988,8.392,4.819
39111,Ohio,Monroe County,14239,43299,45.8,10251,708,459,4682,86,165,533,497,36,520,460,60,610,526,84,582,478,104,11.384,5.361,3.524
39113,Ohio,Montgomery County,531987,47045,39.3,362689,58083,39029,136713,4312,8056,25097,21004,4093,25520,22303,3217,30003,24608,5395,30922,27381,3541,26.776,9.047,5.893
39155,Ohio,Trumbull County,203341,45380,44,144530,18352,8676,61185,1491,2874,8319,6368,1951,7923,6823,1100,9249,7424,1825,9718,8927,791,18.701,7.134,4.697
39165,Ohio,Warren County,223868,79397,39.1,149409,39973,22616,62593,1988,3472,7542,6672,870,7652,7245,407,9777,8985,792,11092,10168,924,41.891,8.723,5.547
39173,Ohio,Wood County,129504,58033,34.6,79713,14867,10827,32992,793,1343,10513,9656,857,11035,10570,465,7148,6234,914,6516,6013,503,32.233,6.474,4.071
39005,Ohio,Ashland County,53299,50893,40.4,35269,4481,2643,14890,374,689,2591,2233,358,2951,2481,470,2602,2220,382,2416,2095,321,20.199,7.139,4.627
39007,Ohio,Ashtabula County,98622,43017,42.5,68750,6082,3114,26982,782,1487,3580,2657,923,3486,2947,539,4521,3622,899,4709,3936,773,13.376,8.409,5.511
40001,Oklahoma,Adair County,22136,33366,37.2,14315,1450,494,5438,88,287,925,351,574,972,527,445,1188,569,619,1218,741,477,13.58,6.896,5.278
40133,Oklahoma,Seminole County,25246,37741,39.2,16523,1498,793,6475,211,218,1118,667,451,1016,625,391,1175,729,446,1248,804,444,13.866,6.625,3.367
40137,Oklahoma,Stephens County,44293,44805,40.5,30383,3865,1423,12320,240,590,1608,1208,400,1759,1301,458,2327,1640,687,2261,1641,620,17.404,6.737,4.789
40025,Oklahoma,Cimarron County,2221,44667,44.6,1568,277,56,722,2,22,65,42,23,59,49,10,113,90,23,111,72,39,21.237,3.324,3.047
40011,Oklahoma,Blaine County,9680,46362,42.1,6929,813,367,2907,41,74,235,194,41,288,248,40,297,185,112,407,268,139,17.03,3.956,2.546
40019,Oklahoma,Carter County,48407,47754,38.1,32059,4269,2260,12649,333,605,2054,1505,549,1898,1290,608,2658,1865,793,2642,2091,551,20.366,7.416,4.783
40029,Oklahoma,Coal County,5666,39931,41.8,3797,382,247,1610,28,82,238,153,85,201,118,83,242,130,112,273,195,78,16.566,6.832,5.093
40053,Oklahoma,Grant County,4458,54460,44,3083,621,176,1428,25,21,133,72,61,149,121,28,195,170,25,207,195,12,25.851,3.221,1.471
40055,Oklahoma,Greer County,6018,35898,39.6,4290,457,157,1560,11,24,260,224,36,231,175,56,329,263,66,243,222,21,14.312,2.244,1.538
40073,Oklahoma,Kingfisher County,15510,62829,36.6,10122,1652,749,4561,98,132,559,374,185,536,425,111,918,643,275,993,737,256,23.721,5.043,2.894
40087,Oklahoma,McClain County,37919,62081,38.3,25078,4371,1672,10828,260,678,1534,1216,318,1379,980,399,1982,1574,408,2112,1750,362,24.097,8.663,6.262
40091,Oklahoma,McIntosh County,19874,38163,47,14439,1323,638,6440,176,239,748,458,290,724,546,178,783,382,401,908,564,344,13.581,6.444,3.711
40095,Oklahoma,Marshall County,16226,45671,43.2,11159,1090,544,4715,92,202,645,400,245,551,366,185,722,480,242,747,499,248,14.643,6.235,4.284
40099,Oklahoma,Murray County,13797,51844,42.2,9544,1245,643,3574,57,34,505,349,156,489,303,186,772,522,250,716,587,129,19.782,2.546,0.951
40103,Oklahoma,Noble County,11421,52372,41.5,7791,1361,500,3376,101,99,411,351,60,411,359,52,609,507,102,598,563,35,23.887,5.924,2.932
40105,Oklahoma,Nowata County,10448,41282,42.3,7205,582,250,3078,73,157,400,294,106,384,199,185,499,361,138,538,413,125,11.548,7.472,5.101
40115,Oklahoma,Ottawa County,31725,38472,38.2,20627,1839,1053,8245,233,431,1541,1027,514,1564,1068,496,1488,1004,484,1622,1141,481,14.02,8.053,5.227
40131,Oklahoma,Rogers County,90098,61320,38.7,59989,10040,4077,26653,797,1251,4044,3067,977,3881,3247,634,4761,3643,1118,4802,3770,1032,23.533,7.684,4.694
40135,Oklahoma,Sequoyah County,41364,37455,40.7,28253,2768,1120,10967,328,565,1749,997,752,1574,1026,548,2125,1203,922,2191,1426,765,13.761,8.143,5.152
40145,Oklahoma,Wagoner County,76830,59210,38.5,51623,8482,3220,22424,684,1128,3095,2174,921,2677,2079,598,4161,3239,922,4568,3575,993,22.668,8.081,5.03
40003,Oklahoma,Alfalfa County,5877,57432,43.8,4331,651,255,1503,23,29,192,125,67,174,132,42,364,287,77,215,166,49,20.919,3.46,1.929
40151,Oklahoma,Woods County,9132,57097,33.8,5767,1082,719,2288,41,55,735,517,218,660,569,91,545,437,108,438,350,88,31.229,4.196,2.404
40015,Oklahoma,Caddo County,29437,41626,37.1,19403,2425,873,7232,84,242,1303,765,538,1163,715,448,1848,1172,676,1410,967,443,16.997,4.508,3.346
40027,Oklahoma,Cleveland County,274024,60632,33.6,172643,34763,20588,66450,1836,3374,20105,16958,3147,19026,16174,2852,18144,14335,3809,17731,15236,2495,32.061,7.84,5.078
40101,Oklahoma,Muskogee County,69471,41329,37.7,46106,6141,2561,17364,489,956,3028,1676,1352,2996,1887,1109,3531,2561,970,3685,2505,1180,18.874,8.322,5.506
40107,Oklahoma,Okfuskee County,12160,38346,40,8249,667,329,2904,48,114,538,296,242,468,277,191,573,383,190,534,317,217,12.074,5.579,3.926
40005,Oklahoma,Atoka County,13899,37106,40.8,9662,964,443,3869,83,191,443,273,170,530,397,133,426,253,173,641,443,198,14.562,7.082,4.937
40013,Oklahoma,Bryan County,45068,41197,37.8,29985,4341,2418,10658,268,446,2178,1453,725,2298,1563,735,2744,2139,605,2649,1876,773,22.541,6.699,4.185
40043,Oklahoma,Dewey County,4904,52930,40.6,3222,527,176,1263,29,36,201,90,111,150,120,30,224,189,35,227,158,69,21.819,5.146,2.85
40059,Oklahoma,Harper County,3843,46915,38.9,2560,410,199,1086,7,0,119,73,46,115,104,11,173,112,61,217,151,66,23.789,0.645,0
40071,Oklahoma,Kay County,45173,44067,38.6,29785,4408,1571,12328,232,560,2039,1427,612,1931,1368,563,2255,1607,648,2247,1622,625,20.074,6.424,4.543
40083,Oklahoma,Logan County,45326,59133,37.8,29783,5671,2667,12439,254,628,2093,1488,605,2083,1554,529,2482,1850,632,2577,1939,638,27.996,7.091,5.049
40035,Oklahoma,Craig County,14563,40465,42.5,10225,1078,420,3980,90,252,516,338,178,505,373,132,674,488,186,663,485,178,14.65,8.593,6.332
40143,Oklahoma,Tulsa County,637123,52017,35.4,416441,87487,41383,147675,4360,7988,29776,20744,9032,29918,22560,7358,40709,29231,11478,42644,32810,9834,30.946,8.362,5.409
40147,Oklahoma,Washington County,51867,50388,40.1,35422,6559,2995,14454,346,632,2164,1455,709,1918,1478,440,2825,2108,717,2970,2179,791,26.972,6.766,4.372
40017,Oklahoma,Canadian County,132922,69220,35.8,87615,16945,5999,33457,933,1694,5116,4234,882,4839,3868,971,8672,6812,1860,9025,7895,1130,26.187,7.852,5.063
40057,Oklahoma,Harmon County,2758,38264,42.4,1953,327,113,858,16,12,78,68,10,78,67,11,117,67,50,162,153,9,22.529,3.263,1.399
40061,Oklahoma,Haskell County,12746,38017,40.3,8663,858,257,3619,124,188,517,262,255,460,322,138,652,412,240,668,446,222,12.871,8.621,5.195
40077,Oklahoma,Latimer County,10621,40539,40.8,7150,741,425,2737,35,102,526,362,164,521,341,180,529,297,232,542,389,153,16.308,5.005,3.727
40111,Oklahoma,Okmulgee County,39121,39567,39.2,25862,2621,1151,10494,167,521,1851,1231,620,1557,995,562,2006,1413,593,2131,1557,574,14.585,6.556,4.965
40113,Oklahoma,Osage County,47350,47683,42,32961,4170,1755,14119,398,667,1736,1263,473,1455,1176,279,2234,1546,688,2383,1800,583,17.976,7.543,4.724
40139,Oklahoma,Texas County,21409,49469,32.5,13024,1891,812,4529,117,305,1476,1117,359,1085,860,225,1440,1062,378,1199,722,477,20.754,9.318,6.734
40067,Oklahoma,Jefferson County,6270,35933,42.4,4289,387,148,1721,15,88,217,118,99,192,119,73,291,195,96,267,157,110,12.474,5.985,5.113
40127,Oklahoma,Pushmataha County,11132,35414,44.6,7855,735,459,3357,72,124,339,167,172,406,258,148,587,319,268,530,382,148,15.201,5.839,3.694
40047,Oklahoma,Garfield County,62421,50724,35.7,40620,5952,3202,15574,299,635,2318,1657,661,2781,2027,754,3862,2659,1203,3803,2742,1061,22.536,5.997,4.077
40049,Oklahoma,Garvin County,27751,42567,39.2,18572,2015,860,7083,124,278,1057,650,407,1031,670,361,1482,1122,360,1532,1142,390,15.48,5.676,3.925
40069,Oklahoma,Johnston County,11039,38636,39.4,7395,729,497,3031,60,85,497,352,145,446,296,150,482,325,157,629,338,291,16.579,4.784,2.804
40121,Oklahoma,Pittsburg County,44673,44941,41,31384,3309,1794,12969,215,548,1823,1046,777,1649,1070,579,2329,1438,891,2355,1601,754,16.26,5.883,4.225
40123,Oklahoma,Pontotoc County,38289,46689,35.5,24756,4337,2630,9291,223,413,2090,1496,594,2230,1624,606,2359,1560,799,2321,1748,573,28.143,6.845,4.445
40129,Oklahoma,Roger Mills County,3734,51286,41,2447,368,140,968,11,53,143,125,18,171,110,61,156,77,79,173,136,37,20.76,6.612,5.475
40153,Oklahoma,Woodward County,21140,57602,36,13813,1784,958,5273,54,242,1172,1002,170,792,625,167,1125,882,243,1074,849,225,19.851,5.614,4.589
40021,Oklahoma,Cherokee County,48404,39187,35,30014,4760,2433,10874,363,550,3508,1988,1520,3425,2102,1323,2613,1377,1236,2576,1778,798,23.965,8.396,5.058
40041,Oklahoma,Delaware County,41878,38234,46.5,30075,3213,1758,12598,476,949,1499,915,584,1518,1012,506,1758,1014,744,1826,1066,760,16.529,11.311,7.533
40045,Oklahoma,Ellis County,4102,50594,44.1,2844,470,144,1189,10,16,130,80,50,165,123,42,164,107,57,172,150,22,21.589,2.187,1.346
40051,Oklahoma,Grady County,54351,55527,38.6,36548,5126,1766,15270,415,579,2173,1683,490,2131,1743,388,2917,2143,774,3031,2387,644,18.857,6.509,3.792
40119,Oklahoma,Payne County,80634,39149,27.2,43342,8900,7062,15050,495,712,10680,9108,1572,9886,8537,1349,5468,3884,1584,4308,3321,987,36.828,8.02,4.731
40125,Oklahoma,Pottawatomie County,71614,46159,37.6,47015,5694,2786,17840,374,869,3154,2124,1030,3537,2678,859,3739,2615,1124,3934,3015,919,18.037,6.967,4.871
40037,Oklahoma,Creek County,70899,47147,40.3,47963,5274,2208,19555,430,967,2838,1989,849,2677,2030,647,3735,2623,1112,3628,2804,824,15.6,7.144,4.945
40141,Oklahoma,Tillman County,7591,40728,40.9,5173,585,201,2317,28,45,272,178,94,324,241,83,327,233,94,316,197,119,15.194,3.151,1.942
40149,Oklahoma,Washita County,11550,51909,38.6,7717,1200,462,3269,73,82,472,340,132,419,349,70,568,461,107,604,483,121,21.537,4.742,2.508
40033,Oklahoma,Cotton County,6000,49962,41.1,4100,447,199,1774,45,46,230,141,89,218,140,78,321,205,116,267,119,148,15.756,5.13,2.593
40075,Oklahoma,Kiowa County,9127,38191,43.1,6315,786,293,2658,52,66,313,217,96,332,239,93,512,353,159,443,376,67,17.086,4.439,2.483
40079,Oklahoma,Le Flore County,49860,39253,39.6,33599,3145,1859,13432,360,714,2094,1160,934,1889,1204,685,2525,1564,961,2675,1715,960,14.893,7.996,5.316
40089,Oklahoma,McCurtain County,33026,34250,39,21791,2063,888,9050,137,351,1460,846,614,1396,810,586,1638,1130,508,1714,1096,618,13.542,5.392,3.878
40093,Oklahoma,Major County,7730,52056,41.7,5246,673,205,2358,31,66,274,195,79,270,185,85,345,294,51,374,279,95,16.737,4.114,2.799
40097,Oklahoma,Mayes County,40929,45302,40.3,27701,2941,1321,11553,256,560,1731,1072,659,1681,1321,360,2062,1418,644,2157,1564,593,15.386,7.063,4.847
40109,Oklahoma,Oklahoma County,774203,50762,34.4,502958,100887,56012,174898,5065,10416,35618,24436,11182,37619,28762,8857,52461,37403,15058,54244,42402,11842,31.195,8.851,5.955
40039,Oklahoma,Custer County,29169,48520,30.7,17015,3064,1446,6204,83,185,2378,1874,504,2287,2013,274,1875,1277,598,1699,1353,346,26.506,4.32,2.982
40007,Oklahoma,Beaver County,5445,52571,40.5,3624,562,158,1642,25,55,247,190,57,172,133,39,218,165,53,236,172,64,19.868,4.872,3.35
40085,Oklahoma,Love County,9843,49409,40,6513,672,295,2434,46,83,465,354,111,398,322,76,445,330,115,498,420,78,14.847,5.3,3.41
40009,Oklahoma,Beckham County,22971,49625,35.1,15126,1732,791,4971,162,193,887,573,314,863,502,361,1494,1325,169,1238,973,265,16.68,7.141,3.883
40063,Oklahoma,Hughes County,13519,38425,39.8,9414,754,416,3185,56,118,462,269,193,455,254,201,445,267,178,583,372,211,12.428,5.463,3.705
40023,Oklahoma,Choctaw County,14979,30298,42.5,10236,935,345,4091,80,179,537,208,329,497,237,260,713,329,384,794,516,278,12.505,6.331,4.375
40065,Oklahoma,Jackson County,25574,45189,34.2,16280,2140,1294,5710,158,269,1185,1008,177,1194,978,216,1170,790,380,1452,1044,408,21.093,7.478,4.711
40031,Oklahoma,Comanche County,123066,49569,32.6,77391,10578,6336,23051,640,1334,5817,3987,1830,5653,4418,1235,7106,4956,2150,8046,6384,1662,21.855,8.564,5.787
40081,Oklahoma,Lincoln County,34759,47539,41,23526,2371,985,10233,279,533,1379,994,385,1266,921,345,1643,1165,478,1756,1329,427,14.265,7.935,5.209
40117,Oklahoma,Pawnee County,16448,46460,41.7,11242,1188,577,4717,53,239,595,398,197,519,351,168,741,544,197,856,614,242,15.7,6.19,5.067
41047,Oregon,Marion County,330453,53828,36.2,215512,32302,16460,69362,3032,4452,15907,13068,2839,15303,13425,1878,19158,15055,4103,19299,16060,3239,22.626,10.79,6.419
41029,Oregon,Jackson County,212070,48688,43,150788,25454,14918,54232,2342,5348,8254,6730,1524,8581,7272,1309,11578,8621,2957,11592,9747,1845,26.774,14.18,9.861
41019,Oregon,Douglas County,107576,44023,47,79050,8276,5123,30465,1017,2520,4268,3490,778,3580,3160,420,4800,4121,679,5434,4700,734,16.95,11.61,8.272
41023,Oregon,Grant County,7209,44826,53,5515,634,499,2323,48,169,205,137,68,154,127,27,265,220,45,330,277,53,20.544,9.341,7.275
41031,Oregon,Jefferson County,22707,48464,40.6,15437,1787,825,5243,288,394,901,664,237,881,791,90,1072,730,342,1078,885,193,16.92,13.008,7.515
41053,Oregon,Polk County,79666,56032,37.3,50916,9213,6389,18806,777,1491,4819,3848,971,4721,4244,477,3963,3182,781,4132,3502,630,30.643,12.06,7.928
41005,Oregon,Clackamas County,399962,72408,41.4,280125,63746,35303,107039,4666,8544,15931,13748,2183,15292,13640,1652,21696,18290,3406,21674,19007,2667,35.359,12.341,7.982
41017,Oregon,Deschutes County,175321,59152,42.1,125844,26914,15539,45441,2059,4567,6486,5320,1166,5927,4785,1142,9712,7375,2337,9847,8410,1437,33.735,14.582,10.05
41043,Oregon,Linn County,121074,49515,39.7,83348,10874,4662,29649,1240,2335,5007,3948,1059,4587,3986,601,6957,5824,1133,7204,6096,1108,18.64,12.058,7.875
41057,Oregon,Tillamook County,25840,45061,48,19174,2397,1581,7235,358,727,871,693,178,948,798,150,1117,832,285,1119,973,146,20.747,14.997,10.048
41071,Oregon,Yamhill County,102366,58392,38.2,68229,11017,6282,24428,963,1825,4985,4045,940,4969,4503,466,5302,4085,1217,5553,4798,755,25.354,11.413,7.471
41001,Oregon,Baker County,15980,43765,47.9,11828,1740,937,4806,122,367,508,377,131,390,320,70,776,652,124,800,659,141,22.633,10.175,7.636
41033,Oregon,Josephine County,84514,40705,47.6,62130,6755,4183,23631,1041,2666,2860,2329,531,2578,2090,488,3784,2648,1136,3847,3181,666,17.605,15.687,11.282
41035,Oregon,Klamath County,66018,42531,42.6,46067,5540,3185,17659,505,1207,2994,2256,738,2973,2471,502,3247,2706,541,3343,2747,596,18.94,9.695,6.835
41059,Oregon,Umatilla County,76736,50071,36.1,49897,4871,3078,16967,690,946,3458,2761,697,3022,2410,612,4159,3128,1031,4084,3240,844,15.931,9.642,5.576
41041,Oregon,Lincoln County,47307,43291,50.9,36212,5269,3453,13145,576,1336,1501,1141,360,1437,1103,334,1986,1388,598,2167,1650,517,24.086,14.545,10.164
41003,Oregon,Benton County,88249,54682,32.8,53410,15512,13217,19787,530,1066,10425,9423,1002,8287,7746,541,5071,4170,901,4763,4221,542,53.79,8.066,5.387
41009,Oregon,Columbia County,50207,57449,43.3,35566,4660,1972,14020,549,825,1895,1604,291,1577,1444,133,2290,1809,481,2442,2118,324,18.647,9.8,5.884
41013,Oregon,Crook County,21717,41777,48,16223,1926,972,6293,211,673,678,532,146,648,559,89,968,872,96,1012,930,82,17.864,14.047,10.694
41055,Oregon,Sherman County,1635,42074,51.7,1305,152,78,497,5,31,50,29,21,35,22,13,90,19,71,55,24,31,17.625,7.243,6.237
41065,Oregon,Wasco County,25687,48510,40.9,17862,2330,1201,6497,248,555,1051,870,181,906,706,200,1399,1147,252,1406,1247,159,19.768,12.36,8.542
41025,Oregon,Harney County,7195,39504,46.2,5191,622,373,2152,17,190,236,203,33,216,192,24,321,283,38,312,297,15,19.168,9.619,8.829
41039,Oregon,Lane County,363471,47710,39.4,247148,43756,29358,87539,3883,7518,23517,19638,3879,22525,19503,3022,20983,16804,4179,19929,16890,3039,29.583,13.024,8.588
41045,Oregon,Malheur County,30421,37112,36.1,19716,1796,805,5953,206,523,1519,1141,378,1147,835,312,1239,968,271,1430,1138,292,13.192,12.246,8.785
41063,Oregon,Wallowa County,6864,44877,52.7,5390,869,519,2123,65,178,118,103,15,129,91,38,342,281,61,333,328,5,25.751,11.446,8.384
41067,Oregon,Washington County,572071,74033,36.4,387890,103494,61032,129376,5479,9509,24562,20014,4548,24627,21578,3049,40024,32771,7253,38350,33569,4781,42.416,11.585,7.35
41069,Oregon,Wheeler County,1415,33563,57.9,1110,123,52,501,16,49,52,51,1,38,32,6,51,30,21,56,55,1,15.766,12.974,9.78
41049,Oregon,Morrow County,11153,54386,39.2,7091,544,150,2791,80,132,432,322,110,423,318,105,540,401,139,502,393,109,9.787,7.596,4.729
41007,Oregon,Clatsop County,38021,49828,44.1,27397,4101,2598,9756,383,856,1379,1050,329,1378,1216,162,1913,1379,534,1977,1646,331,24.452,12.7,8.774
41011,Oregon,Coos County,62921,40848,48.3,46700,5198,3495,17261,767,1183,2061,1454,607,2289,1828,461,2971,2407,564,2749,2258,491,18.615,11.297,6.854
41015,Oregon,Curry County,22377,42519,55.6,17848,2664,1522,7009,223,539,773,639,134,746,729,17,681,427,254,667,612,55,23.454,10.872,7.69
41021,Oregon,Gilliam County,1910,39831,47,1373,200,64,515,13,42,66,53,13,47,22,25,56,56,0,96,96,0,19.228,10.68,8.155
41027,Oregon,Hood River County,22938,57269,39,15415,2864,1798,5451,258,362,1017,671,346,858,697,161,1282,969,313,1286,1174,112,30.243,11.374,6.641
41037,Oregon,Lake County,7807,32769,48.8,5825,600,260,2097,115,125,276,200,76,266,262,4,221,201,20,320,294,26,14.764,11.445,5.961
41051,Oregon,Multnomah County,788459,60369,36.8,568260,150503,98219,172892,8453,15772,34672,28277,6395,35578,31162,4416,65850,52659,13191,67518,59562,7956,43.769,14.012,9.122
41061,Oregon,Union County,25810,46228,39.8,17161,2789,1333,6512,254,429,1380,1173,207,1329,1230,99,1323,1050,273,1368,1152,216,24.02,10.488,6.588
42045,Pennsylvania,Delaware County,563384,69839,39,380274,82534,60727,142566,5344,11291,27580,24736,2844,28273,25831,2442,30494,25522,4972,32606,29130,3476,37.673,11.668,7.92
42055,Pennsylvania,Franklin County,153003,58267,41.3,106187,13003,8886,42413,1313,2031,5568,4438,1130,6163,5309,854,8230,6299,1931,7783,6564,1219,20.614,7.884,4.789
42119,Pennsylvania,Union County,45056,53768,39.4,30664,3907,3376,10404,338,413,3095,2524,571,2443,2196,247,1775,1311,464,1906,1549,357,23.751,7.218,3.97
42127,Pennsylvania,Wayne County,51656,52161,47.7,39052,4717,3244,15214,527,1386,1959,1705,254,1614,1418,196,1971,1576,395,2043,1932,111,20.386,12.574,9.11
42009,Pennsylvania,Bedford County,48891,48703,45.9,35495,2839,2057,15642,354,639,1941,1582,359,1665,1407,258,2080,1735,345,2044,1836,208,13.793,6.348,4.085
42043,Pennsylvania,Dauphin County,273329,57071,39.6,188832,34904,21424,70837,2152,3933,11414,9861,1553,11848,10427,1421,16015,13301,2714,16706,15103,1603,29.83,8.59,5.552
42053,Pennsylvania,Forest County,7388,37106,39.2,6072,272,155,1258,36,62,21,14,7,29,27,2,46,36,10,30,27,3,7.032,7.79,4.928
42111,Pennsylvania,Somerset County,75619,46132,45.9,56253,5819,3021,23296,584,1041,2598,2236,362,2487,2140,347,3287,2700,587,3202,2864,338,15.715,6.975,4.469
42089,Pennsylvania,Monroe County,167306,61430,42.6,114267,17826,9585,44987,3021,5185,9239,7909,1330,8268,7188,1080,7848,6400,1448,7493,6568,925,23.989,18.241,11.526
42101,Pennsylvania,Philadelphia County,1569657,40649,34.1,1051996,166567,118269,308695,11863,31124,88978,70785,18193,95608,83752,11856,119634,92492,27142,129404,111070,18334,27.076,13.925,10.082
42133,Pennsylvania,York County,442216,61707,41,306293,47480,25068,126302,4838,7285,18724,16169,2555,17793,15696,2097,22982,19287,3695,24030,21678,2352,23.686,9.598,5.768
42129,Pennsylvania,Westmoreland County,356835,56702,46.6,261570,46745,26450,117800,2835,5246,14156,12713,1443,13224,12219,1005,16563,14546,2017,16198,14743,1455,27.983,6.86,4.453
42013,Pennsylvania,Blair County,124736,45664,43.1,88352,12370,5585,36185,931,1810,5310,4427,883,5172,4609,563,6658,5662,996,6429,5835,594,20.322,7.575,5.002
42015,Pennsylvania,Bradford County,61546,50900,44.4,43396,5197,2623,18595,387,758,2315,1859,456,2249,2018,231,2801,2300,501,2857,2525,332,18.02,6.158,4.076
42021,Pennsylvania,Cambria County,135871,44943,45,96941,12538,7763,42455,962,1850,5967,5200,767,5470,4976,494,5901,4798,1103,6213,5782,431,20.942,6.623,4.358
42029,Pennsylvania,Chester County,514652,92417,40.3,347586,105643,71621,141800,5517,10138,22450,19437,3013,22377,20528,1849,25801,21541,4260,25774,22776,2998,50.999,11.04,7.15
42011,Pennsylvania,Berks County,415500,59580,39.9,279980,43700,23251,111104,4028,7239,19486,16256,3230,19225,17124,2101,21759,18246,3513,22275,19715,2560,23.913,10.141,6.516
42061,Pennsylvania,Huntingdon County,45686,46765,42.9,32575,3395,1573,12724,262,694,1819,1547,272,2050,1903,147,1842,1526,316,1932,1726,206,15.251,7.513,5.454
42063,Pennsylvania,Indiana County,86551,46306,39.7,55950,7622,5102,23857,490,1190,6333,5623,710,6637,5856,781,4223,3328,895,3674,3096,578,22.742,7.042,4.988
42073,Pennsylvania,Lawrence County,88231,47188,44.9,62962,8535,4535,27219,651,1533,3495,3042,453,3725,3314,411,4291,3714,577,3982,3615,367,20.759,8.024,5.632
42087,Pennsylvania,Mifflin County,46452,46286,43.6,32506,2744,1222,13299,321,594,1775,1371,404,1646,1331,315,2313,1793,520,2237,1903,334,12.201,6.88,4.467
42125,Pennsylvania,Washington County,207661,59309,44.4,148476,28447,14659,63420,1781,2946,8874,7881,993,8505,7730,775,10284,8739,1545,10038,9127,911,29.032,7.453,4.645
42041,Pennsylvania,Cumberland County,245801,65544,40.5,171176,36349,23099,69237,1993,3522,10768,9500,1268,11544,10707,837,13993,11896,2097,13597,12189,1408,34.729,7.965,5.087
42003,Pennsylvania,Allegheny County,1229605,56333,40.9,882896,207014,145928,348012,8385,17340,57260,51651,5609,58273,54445,3828,81542,70648,10894,80608,73593,7015,39.975,7.392,4.983
42103,Pennsylvania,Pike County,55687,63417,47,40380,6575,4136,17981,695,1940,2235,1913,322,2144,1931,213,2215,1786,429,1854,1663,191,26.526,14.654,10.789
42109,Pennsylvania,Snyder County,40570,54182,39.7,26871,3022,1684,10594,279,465,2113,1734,379,2219,1914,305,1984,1330,654,1965,1543,422,17.513,7.023,4.389
42115,Pennsylvania,Susquehanna County,41716,52014,47.8,30675,3363,2011,13413,331,903,1523,1293,230,1329,1157,172,1938,1410,528,1827,1589,238,17.519,9.2,6.732
42039,Pennsylvania,Crawford County,86847,47179,42.8,60171,7531,4756,25551,687,1072,3855,3104,751,3797,3034,763,4094,3268,826,4161,3489,672,20.42,6.884,4.196
42049,Pennsylvania,Erie County,277794,48192,39,188102,33980,17652,72959,2093,3340,14412,12478,1934,14008,12752,1256,15231,12851,2380,15690,14198,1492,27.449,7.447,4.578
42057,Pennsylvania,Fulton County,14631,50007,44.6,10462,823,585,4670,143,247,594,521,73,473,424,49,702,522,180,697,598,99,13.458,8.351,5.289
42067,Pennsylvania,Juniata County,24448,50571,42.8,17088,1497,898,7082,260,246,928,707,221,905,712,193,1257,1026,231,1194,1012,182,14.016,7.145,3.474
42107,Pennsylvania,Schuylkill County,144287,47642,44.2,105438,10914,5935,43942,1050,1996,5109,4328,781,4603,3854,749,7177,6172,1005,6898,6076,822,15.98,6.932,4.542
42131,Pennsylvania,Wyoming County,27760,55965,44,19657,2431,1273,8415,228,530,1242,1157,85,1108,994,114,1376,1179,197,1297,1158,139,18.843,9.008,6.298
42001,Pennsylvania,Adams County,101589,62661,43.3,70861,9072,6605,30191,1093,1600,4636,3956,680,4483,4019,464,4912,4193,719,4750,4106,644,22.124,8.92,5.3
42005,Pennsylvania,Armstrong County,66737,47527,46,48920,5002,2443,21421,609,982,2377,2054,323,2244,2019,225,3341,2888,453,3138,2785,353,15.219,7.427,4.584
42035,Pennsylvania,Clinton County,39321,47990,38.5,25238,2852,1683,10378,286,535,2564,2127,437,2945,2632,313,1858,1493,365,1708,1520,188,17.969,7.911,5.155
42025,Pennsylvania,Carbon County,63987,51236,45.7,46941,4826,2703,20092,822,1273,2141,1919,222,2057,1910,147,3119,2575,544,3154,2753,401,16.039,10.427,6.336
42027,Pennsylvania,Centre County,160646,56466,31.3,96043,22186,19790,35427,752,1710,19744,18265,1479,16318,15245,1073,10181,8642,1539,8415,7960,455,43.705,6.95,4.827
42097,Pennsylvania,Northumberland County,93038,44534,44.3,67574,6702,3676,28000,738,1442,3269,2761,508,3371,3030,341,4594,3715,879,4503,4021,482,15.358,7.786,5.15
42095,Pennsylvania,Northampton County,300941,65390,42,209237,38279,21982,81540,3489,5342,15245,13544,1701,13490,11950,1540,15820,13264,2556,15302,13921,1381,28.8,10.83,6.551
42023,Pennsylvania,Cameron County,4754,40402,50.8,3588,391,181,1583,24,102,189,158,31,182,174,8,183,162,21,159,154,5,15.942,7.96,6.443
42121,Pennsylvania,Venango County,52880,46487,46,38339,4359,2229,16403,334,614,1934,1599,335,1719,1525,194,2420,1968,452,2530,2257,273,17.184,5.779,3.743
42007,Pennsylvania,Beaver County,168161,53981,44.9,121982,20085,9221,51609,1154,2417,6609,5740,869,6286,5768,518,8759,7442,1317,8441,7752,689,24.025,6.919,4.683
42017,Pennsylvania,Bucks County,626486,82031,43.6,443646,104639,70111,180670,8175,14212,23905,21802,2103,23802,22126,1676,31220,27316,3904,30646,27896,2750,39.39,12.391,7.866
42069,Pennsylvania,Lackawanna County,211960,48380,42.2,149213,25419,14857,56356,1509,3798,9262,8330,932,10334,9802,532,11434,9457,1977,11226,10016,1210,26.992,9.417,6.739
42077,Pennsylvania,Lehigh County,360774,60116,39.4,245179,43443,27929,89550,3088,5487,15871,12711,3160,16734,14790,1944,20237,16361,3876,20580,18117,2463,29.11,9.576,6.127
42083,Pennsylvania,McKean County,42070,45866,42.5,29718,3277,1898,12696,303,591,1992,1818,174,1729,1588,141,1971,1670,301,1920,1774,146,17.414,7.042,4.655
42051,Pennsylvania,Fayette County,133160,41632,44.6,97009,10311,4651,39459,1018,1865,5177,4338,839,4986,4442,544,6643,5533,1110,6350,5629,721,15.423,7.306,4.726
42031,Pennsylvania,Clarion County,38747,44373,41.3,26281,3488,2248,11058,218,404,2434,2150,284,2561,2269,292,1920,1618,302,1840,1634,206,21.826,5.625,3.653
42091,Pennsylvania,Montgomery County,818677,84791,41.2,573128,154681,121832,225724,9041,16025,32473,29732,2741,32341,30393,1948,44385,38808,5577,45507,41637,3870,48.246,11.105,7.099
42033,Pennsylvania,Clearfield County,80539,45188,44.2,59080,5836,2515,23969,638,1199,3152,2524,628,2761,2498,263,3786,3143,643,3464,3015,449,14.135,7.664,5.002
42059,Pennsylvania,Greene County,37338,50972,42,26529,3051,1721,10670,184,449,1694,1489,205,1628,1454,174,1675,1457,218,1761,1625,136,17.988,5.933,4.208
42075,Pennsylvania,Lebanon County,137616,57698,41.2,94169,11992,7190,36703,1004,1748,5679,4385,1294,5661,4821,840,7050,5593,1457,7212,6127,1085,20.37,7.498,4.763
42081,Pennsylvania,Lycoming County,115398,50634,41,80444,11549,6191,32145,859,1893,5850,4909,941,5164,4676,488,6483,5409,1074,5996,5271,725,22.053,8.561,5.889
42079,Pennsylvania,Luzerne County,318222,49290,43,226690,32366,19329,87714,2648,4853,14872,12695,2177,13808,12252,1556,16862,13923,2939,16381,14573,1808,22.804,8.552,5.533
42093,Pennsylvania,Montour County,18302,56250,43,13425,2263,1836,5293,80,204,659,626,33,543,524,19,1133,934,199,1130,1003,127,30.533,5.366,3.854
42123,Pennsylvania,Warren County,40345,45781,46.7,29457,3756,1800,13026,275,530,1479,1300,179,1303,1145,158,1826,1550,276,1797,1623,174,18.861,6.18,4.069
42037,Pennsylvania,Columbia County,66615,48395,40.5,43966,5961,3557,18336,441,848,4392,4013,379,5212,4898,314,3056,2632,424,3028,2698,330,21.649,7.03,4.625
42019,Pennsylvania,Butler County,185984,66037,43.1,130903,29117,16209,57630,1325,2118,8276,7522,754,7619,7012,607,8997,8155,842,9067,8381,686,34.626,5.974,3.675
42047,Pennsylvania,Elk County,30781,49876,46.7,22527,2833,1344,10598,155,297,1112,964,148,1121,1055,66,1406,1140,266,1212,1180,32,18.542,4.265,2.802
42065,Pennsylvania,Jefferson County,44258,45342,43.9,31358,3341,1628,13813,348,478,1805,1435,370,1720,1464,256,2241,1785,456,2132,1830,302,15.846,5.98,3.461
42071,Pennsylvania,Lancaster County,536494,61492,38.5,357748,60405,34297,135368,4491,7993,24399,20095,4304,25488,21136,4352,29994,24124,5870,30025,24937,5088,26.472,9.222,5.905
42085,Pennsylvania,Mercer County,113623,47340,44.4,79399,11097,6601,33516,750,1583,5380,4747,633,5169,4379,790,4821,3920,901,4833,4297,536,22.29,6.961,4.723
42099,Pennsylvania,Perry County,45878,60847,43,32359,3666,1704,14372,550,625,1791,1379,412,1635,1369,266,2289,1808,481,2392,2165,227,16.595,8.176,4.349
42105,Pennsylvania,Potter County,17070,41406,46.7,12212,1125,712,5045,187,263,631,500,131,579,513,66,779,610,169,716,612,104,15.043,8.92,5.213
42113,Pennsylvania,Sullivan County,6192,45519,53.1,4901,497,314,2159,62,144,334,264,70,199,164,35,224,163,61,231,219,12,16.548,9.541,6.67
42117,Pennsylvania,Tioga County,41550,50017,44,29294,3563,2346,11918,331,711,1806,1530,276,1846,1684,162,2132,1641,491,2095,1679,416,20.171,8.743,5.966
44005,Rhode Island,Newport County,83204,75463,44.6,60267,16852,11171,21973,767,2179,3505,2969,536,3751,3405,346,3599,3048,551,3972,3594,378,46.498,13.407,9.917
44003,Rhode Island,Kent County,164012,69047,43.7,120189,24534,14063,48648,2120,4546,6383,5492,891,6533,6199,334,9297,8020,1277,9097,8406,691,32.114,13.703,9.345
44007,Rhode Island,Providence County,633704,52530,37.3,429318,72891,46504,126847,6266,12523,35427,29770,5657,36507,32710,3797,40710,31893,8817,40539,35950,4589,27.81,14.812,9.873
44001,Rhode Island,Bristol County,49028,74630,44.1,34043,8420,7502,13466,472,1123,2513,2350,163,2291,2195,96,2253,1967,286,2195,1946,249,46.77,11.845,8.34
44009,Rhode Island,Washington County,126190,77862,44.1,85444,21818,16641,36357,1500,2708,8522,8147,375,8541,8225,316,4952,4182,770,5060,4577,483,45.011,11.574,7.448
45003,South Carolina,Aiken County,165707,47713,41,115170,18831,10940,47484,1444,2459,6715,5124,1591,7043,5516,1527,8793,6078,2715,9587,7592,1995,25.85,8.22,5.179
45005,South Carolina,Allendale County,9402,23331,40.6,6676,457,172,2173,45,100,353,325,28,380,243,137,453,208,245,389,364,25,9.422,6.673,4.602
45071,South Carolina,Newberry County,37914,39600,41.5,25802,3004,1420,10844,326,594,1843,1431,412,1610,1449,161,1753,1183,570,1754,1512,242,17.146,8.484,5.478
45037,South Carolina,Edgefield County,26620,47500,42.6,19340,2372,1396,6770,130,364,1165,1016,149,882,834,48,1219,900,319,1149,946,203,19.483,7.297,5.377
45023,South Carolina,Chester County,32424,37421,41.8,22373,2266,931,9291,110,432,1355,826,529,1244,1043,201,1468,1107,361,1643,1348,295,14.29,5.834,4.65
45027,South Carolina,Clarendon County,34156,35838,43.6,23956,2357,1215,10160,217,664,1105,731,374,1369,955,414,1455,1033,422,1608,1340,268,14.911,8.671,6.535
45029,South Carolina,Colleton County,37581,34996,42.2,26057,2701,1300,11016,379,631,1593,975,618,1464,1166,298,1774,1282,492,2050,1638,412,15.355,9.168,5.728
45067,South Carolina,Marion County,31765,31129,40,21698,2431,1138,8208,346,549,1287,826,461,1324,1097,227,1543,948,595,1688,1259,429,16.449,10.904,6.689
45085,South Carolina,Sumter County,107379,41946,36,69550,8504,5067,26860,894,1741,5115,3852,1263,5218,3944,1274,5499,3943,1556,6428,5235,1193,19.513,9.81,6.482
45063,South Carolina,Lexington County,281870,57482,38.9,192759,37529,20523,80472,2546,4335,11126,8531,2595,11403,9596,1807,16247,11796,4451,17308,14500,2808,30.116,8.551,5.387
45073,South Carolina,Oconee County,75926,43978,45,54468,7719,5454,22872,784,1198,3404,2505,899,2907,2185,722,3553,2547,1006,3639,2544,1095,24.185,8.666,5.238
45011,South Carolina,Barnwell County,21788,34035,40.6,14386,1187,494,5826,83,339,1078,638,440,827,657,170,933,587,346,1129,811,318,11.685,7.243,5.819
45015,South Carolina,Berkeley County,204632,56697,35.8,134623,20946,10458,51215,2014,3441,9348,7017,2331,8618,6963,1655,12262,9170,3092,13363,10891,2472,23.327,10.651,6.719
45019,South Carolina,Charleston County,387847,57882,37.2,272967,72787,41548,93308,3555,8878,18935,15267,3668,19342,16163,3179,27152,19911,7241,29850,24101,5749,41.886,13.325,9.515
45031,South Carolina,Darlington County,67572,36217,41.2,46063,5290,2921,18431,509,1145,3120,2220,900,3019,2218,801,2952,2155,797,3607,2973,634,17.826,8.974,6.212
45043,South Carolina,Georgetown County,61065,46967,48.5,44790,7486,4657,18992,775,1543,1929,1208,721,2001,1475,526,2596,1551,1045,2614,1823,791,27.111,12.205,8.124
45069,South Carolina,Marlboro County,27505,33921,39.9,19603,1137,603,6429,143,297,1037,860,177,967,711,256,1348,949,399,1205,942,263,8.876,6.844,4.62
45091,South Carolina,York County,251664,59394,38.3,167738,35168,16922,67863,2551,3297,10034,8290,1744,11189,9710,1479,13403,10111,3292,14813,12454,2359,31.054,8.617,4.858
45007,South Carolina,Anderson County,194174,45551,40.5,132734,17584,9970,53847,1365,2793,8081,6333,1748,8228,6567,1661,9751,7295,2456,10703,8213,2490,20.759,7.722,5.187
45021,South Carolina,Cherokee County,56549,35286,38.9,37714,3656,2016,14446,512,674,2746,2019,727,2723,1922,801,2752,2017,735,3163,2331,832,15.04,8.21,4.666
45025,South Carolina,Chesterfield County,46127,38469,41.9,31679,2329,1236,13143,284,816,2121,1547,574,2008,1536,472,2259,1517,742,2267,1817,450,11.254,8.369,6.209
45047,South Carolina,Greenwood County,69981,39196,39.3,47073,7105,3866,17365,547,1004,2995,2209,786,3426,2845,581,3473,2366,1107,4138,3153,985,23.306,8.932,5.782
45053,South Carolina,Jasper County,27465,39740,38.1,19161,1894,946,6737,388,554,1245,725,520,1293,1032,261,1991,1286,705,1443,894,549,14.822,13.982,8.223
45051,South Carolina,Horry County,310186,46475,44.4,226485,34246,17787,87486,3291,7258,12374,8830,3544,12970,9776,3194,16358,9488,6870,16345,12017,4328,22.974,12.058,8.296
45055,South Carolina,Kershaw County,63734,46565,41.8,43847,5489,3472,20109,722,1391,2511,1719,792,2385,1867,518,3162,2280,882,3316,2659,657,20.437,10.508,6.917
45061,South Carolina,Lee County,17897,31963,41.7,12389,979,461,4864,82,358,864,625,239,616,415,201,713,462,251,805,635,170,11.623,9.046,7.36
45075,South Carolina,Orangeburg County,89116,34943,39.5,59344,7166,4784,22673,530,1419,4435,3023,1412,5030,4109,921,4236,2766,1470,4945,3890,1055,20.137,8.596,6.259
45083,South Carolina,Spartanburg County,297732,47575,38.3,199413,30238,17240,78103,2042,4438,13848,9905,3943,14782,11586,3196,15626,11446,4180,16881,13470,3411,23.809,8.297,5.682
45001,South Carolina,Abbeville County,24788,35254,43.7,17110,1708,809,7236,80,515,1158,870,288,1196,957,239,1104,866,238,945,627,318,14.711,8.223,7.117
45009,South Carolina,Bamberg County,14842,32330,41.8,9902,1245,646,4244,38,194,1021,756,265,756,469,287,630,335,295,604,459,145,19.097,5.467,4.571
45013,South Carolina,Beaufort County,179316,60603,44,126904,29771,20789,48493,2346,5124,7077,4827,2250,6309,4802,1507,7316,4878,2438,9097,6788,2309,39.841,15.404,10.566
45017,South Carolina,Calhoun County,14808,44010,45.9,10738,1260,699,4878,72,289,624,498,126,605,486,119,597,471,126,639,529,110,18.244,7.401,5.925
45033,South Carolina,Dillon County,31073,30866,37.4,20367,1574,700,7226,106,389,1422,577,845,1303,1025,278,1578,944,634,1926,1352,574,11.165,6.85,5.383
45081,South Carolina,Saluda County,20228,41885,40.6,14049,1554,735,5070,205,229,842,510,332,789,486,303,1058,715,343,939,673,266,16.293,8.56,4.517
45079,South Carolina,Richland County,404869,52082,33,251220,57016,37744,87981,3469,6569,25986,21833,4153,26282,22699,3583,22819,17532,5287,25604,21307,4297,37.72,11.409,7.466
45039,South Carolina,Fairfield County,22868,35551,45.4,16425,2103,792,6607,147,187,720,481,239,1043,687,356,1021,721,300,1053,803,250,17.626,5.055,2.83
45049,South Carolina,Hampton County,20066,32147,39.9,13920,1069,556,5399,167,273,914,628,286,766,540,226,841,625,216,968,871,97,11.674,8.15,5.056
45045,South Carolina,Greenville County,490332,53739,38,330804,70027,40223,122809,3828,6682,22320,17322,4998,22854,18528,4326,28174,20265,7909,30676,24577,6099,33.328,8.558,5.441
45057,South Carolina,Lancaster County,86544,50557,42,61355,10066,5312,24814,742,1427,2984,2228,756,2682,2286,396,4154,2847,1307,4801,4077,724,25.064,8.741,5.751
45035,South Carolina,Dorchester County,151716,58685,36.2,100767,17690,9938,38389,1724,3268,6550,4834,1716,5922,4870,1052,8190,6325,1865,9873,8303,1570,27.418,13.004,8.513
45041,South Carolina,Florence County,138537,43310,38.8,92623,13549,7318,34284,1126,1954,6002,4764,1238,6703,5559,1144,6876,4930,1946,8416,7279,1137,22.529,8.984,5.699
45059,South Carolina,Laurens County,66508,40580,40.8,45268,4320,2298,18244,517,986,3272,2233,1039,3366,2815,551,3112,2062,1050,3335,2602,733,14.62,8.238,5.405
45065,South Carolina,McCormick County,9694,40622,52.8,7963,1073,466,3103,100,128,261,107,154,277,252,25,406,303,103,241,185,56,19.327,7.348,4.125
45077,South Carolina,Pickens County,121449,45332,36.2,76092,10740,7191,31576,831,1684,10794,9731,1063,9435,8233,1202,6557,4852,1705,5904,4576,1328,23.565,7.965,5.333
45087,South Carolina,Union County,27772,37493,43.7,19686,1566,899,8123,193,366,1233,907,326,1150,1012,138,1098,741,357,1384,1234,150,12.522,6.882,4.506
45089,South Carolina,Williamsburg County,32256,30976,41.7,22550,1910,930,9069,221,652,1275,975,300,1447,1103,344,1463,1058,405,1418,1037,381,12.594,9.626,7.189
46003,South Dakota,Aurora County,2739,57257,39.9,1819,305,62,915,30,22,121,107,14,103,88,15,131,103,28,113,108,5,20.176,5.683,2.404
46051,South Dakota,Grant County,7133,56276,43.7,5027,637,112,2681,43,59,200,187,13,239,238,1,309,281,28,320,309,11,14.9,3.805,2.201
46123,South Dakota,Tripp County,5480,48409,46.5,3858,643,210,1677,23,44,195,126,69,149,134,15,219,197,22,226,198,28,22.11,3.995,2.624
46071,South Dakota,Jackson County,3275,38041,31.6,1889,300,112,618,3,13,167,70,97,209,132,77,160,114,46,171,91,80,21.81,2.589,2.104
46099,South Dakota,Minnehaha County,183660,57322,34.7,120239,26035,11096,46899,1163,1990,8345,6923,1422,8975,7996,979,13379,11415,1964,12299,10740,1559,30.881,6.723,4.243
46033,South Dakota,Custer County,8519,56449,53.8,6739,1254,399,3231,168,246,190,173,17,119,54,65,381,252,129,352,270,82,24.529,12.813,7.614
46069,South Dakota,Hyde County,1373,53696,50,1011,158,40,470,8,23,33,25,8,29,23,6,58,35,23,54,48,6,19.585,6.596,4.894
46025,South Dakota,Clark County,3642,47500,41.3,2440,345,94,1175,33,19,199,158,41,131,113,18,180,166,14,162,146,16,17.992,4.426,1.617
46049,South Dakota,Faulk County,2327,46750,48.1,1664,294,150,728,5,36,89,59,30,82,54,28,114,108,6,103,98,5,26.683,5.632,4.945
46067,South Dakota,Hutchinson County,7277,49583,44.3,4987,906,277,2200,26,43,348,245,103,209,169,40,311,292,19,287,268,19,23.722,3.136,1.955
46077,South Dakota,Kingsbury County,5000,58794,46.8,3608,580,221,1855,16,75,180,170,10,165,161,4,225,213,12,240,218,22,22.201,4.906,4.043
46129,South Dakota,Walworth County,5502,46623,44.4,3938,655,225,1633,51,43,143,121,22,111,89,22,262,193,69,251,223,28,22.346,5.756,2.633
46017,South Dakota,Buffalo County,2048,30500,25.3,1030,75,17,222,0,12,100,15,85,115,20,95,106,33,73,117,61,56,8.932,5.405,5.405
46027,South Dakota,Clay County,13907,41773,25,6954,1887,1538,2735,74,120,2011,1840,171,1989,1810,179,840,626,214,712,521,191,49.252,7.093,4.388
46037,South Dakota,Day County,5524,43902,48.4,3999,575,168,1873,54,54,203,160,43,152,106,46,266,178,88,233,194,39,18.58,5.766,2.883
46041,South Dakota,Dewey County,5709,41190,28,3096,330,122,963,8,11,252,49,203,334,165,169,310,114,196,287,156,131,14.599,1.973,1.142
46043,South Dakota,Douglas County,2940,52543,47.5,2056,261,127,978,4,38,100,95,5,103,81,22,149,108,41,81,52,29,18.872,4.294,3.885
46063,South Dakota,Harding County,1281,55972,39.8,883,213,59,379,7,4,63,45,18,10,10,0,112,101,11,81,81,0,30.804,2.902,1.055
46065,South Dakota,Hughes County,17572,59741,38.3,12152,2909,1272,4780,31,140,569,505,64,529,461,68,1048,864,184,953,779,174,34.406,3.577,2.929
46089,South Dakota,McPherson County,2366,41674,50.5,1744,203,64,809,17,5,99,80,19,52,36,16,82,50,32,99,96,3,15.31,2.719,0.618
46109,South Dakota,Roberts County,10250,51228,38.2,6475,770,360,2552,20,62,460,249,211,418,191,227,440,263,177,427,246,181,17.452,3.213,2.429
46111,South Dakota,Sanborn County,2366,54677,45.3,1683,240,71,774,10,23,84,74,10,105,81,24,145,128,17,91,88,3,18.479,4.264,2.972
46119,South Dakota,Sully County,1390,60694,44.9,936,197,36,462,21,6,67,52,15,57,48,9,46,43,3,59,38,21,24.893,5.844,1.299
46083,South Dakota,Lincoln County,53147,81849,34.4,34099,9626,4341,14780,268,543,1729,1548,181,2075,1847,228,3652,3377,275,3794,3447,347,40.96,5.487,3.674
46059,South Dakota,Hand County,3303,50720,47.4,2362,445,135,1041,25,25,140,121,19,85,82,3,153,135,18,148,139,9,24.555,4.803,2.402
46079,South Dakota,Lake County,12350,58467,42,8271,1924,695,3590,136,98,843,787,56,537,498,39,520,423,97,475,313,162,31.665,6.518,2.73
46081,South Dakota,Lawrence County,25018,49275,41.4,17197,3535,1774,6996,273,416,1508,1169,339,1650,1469,181,1423,999,424,1266,1042,224,30.872,9.848,5.946
46135,South Dakota,Yankton County,22660,50029,42.1,15859,2792,1574,6064,168,259,854,712,142,909,866,43,1155,1006,149,1046,893,153,27.53,7.042,4.271
46029,South Dakota,Codington County,27963,52025,38.3,18824,3336,739,7824,185,373,1395,1137,258,1311,1064,247,1606,1455,151,1403,1250,153,21.648,7.132,4.767
46005,South Dakota,Beadle County,18163,48995,37.9,12066,1919,440,5129,213,186,579,524,55,648,569,79,1274,1063,211,1083,846,237,19.551,7.779,3.626
46019,South Dakota,Butte County,10194,44786,40.1,7006,1164,294,3110,107,203,372,189,183,370,245,125,560,330,230,521,452,69,20.811,9.968,6.527
46031,South Dakota,Corson County,4177,32260,28.8,2311,350,60,662,6,12,168,54,114,182,103,79,233,126,107,218,152,66,17.741,2.719,1.813
46035,South Dakota,Davison County,19753,48665,38.2,13256,2356,819,5283,20,239,1163,918,245,825,755,70,1247,1053,194,1006,945,61,23.951,4.903,4.524
46045,South Dakota,Edmunds County,3971,65380,44.4,2724,463,218,1325,26,40,162,133,29,75,61,14,190,151,39,181,168,13,25,4.981,3.019
46021,South Dakota,Campbell County,1443,51548,51.7,1091,214,44,588,8,5,17,17,0,38,35,3,50,47,3,53,49,4,23.648,2.211,0.85
46073,South Dakota,Jerauld County,2034,49882,48.6,1480,214,72,671,14,13,34,19,15,57,44,13,97,72,25,89,77,12,19.324,4.024,1.937
46007,South Dakota,Bennett County,3440,45725,28.8,1907,272,58,581,2,8,145,72,73,141,95,46,178,97,81,204,109,95,17.305,1.721,1.377
46055,South Dakota,Haakon County,2084,38873,45.3,1437,198,58,701,20,22,91,89,2,23,23,0,109,98,11,78,77,1,17.815,5.991,3.138
46117,South Dakota,Stanley County,2994,63233,43.4,2111,324,265,1032,37,18,94,50,44,104,104,0,129,99,30,171,168,3,27.901,5.329,1.744
46075,South Dakota,Jones County,740,39432,53,599,76,19,307,7,2,6,1,5,16,16,0,46,41,5,10,10,0,15.86,2.932,0.651
46093,South Dakota,Meade County,27066,54286,36.1,17665,3261,1108,8117,196,566,1229,1041,188,1054,979,75,1527,1186,341,1595,1194,401,24.733,9.388,6.973
46107,South Dakota,Potter County,2318,51597,52.6,1709,266,114,847,17,27,60,58,2,71,56,15,78,70,8,78,69,9,22.235,5.195,3.188
46125,South Dakota,Turner County,8242,54294,43.7,5782,945,360,2753,56,84,244,219,25,252,222,30,382,315,67,378,318,60,22.57,5.085,3.051
46013,South Dakota,Brown County,38637,53807,37.3,25488,5155,2191,10765,216,422,2138,1662,476,1996,1727,269,2239,1918,321,2218,1977,241,28.821,5.927,3.92
46023,South Dakota,Charles Mix County,9319,44104,36,5747,728,262,2162,23,52,372,198,174,436,233,203,436,283,153,379,230,149,17.226,3.469,2.405
46061,South Dakota,Hanson County,3404,62448,36.2,2070,360,92,937,28,16,138,129,9,99,92,7,112,92,20,157,138,19,21.836,4.696,1.708
46087,South Dakota,McCook County,5515,60808,40.7,3639,575,207,1637,40,25,205,187,18,165,147,18,270,223,47,246,194,52,21.489,3.971,1.527
46091,South Dakota,Marshall County,4759,60948,41.3,3266,593,178,1302,13,56,170,149,21,133,98,35,307,233,74,244,205,39,23.607,5.3,4.301
46095,South Dakota,Mellette County,2062,31165,32.8,1263,166,26,462,6,9,114,32,82,52,9,43,109,20,89,140,89,51,15.202,3.247,1.948
46101,South Dakota,Moody County,6496,56233,40.3,4398,841,212,2020,72,75,275,208,67,198,175,23,322,264,58,344,287,57,23.943,7.277,3.713
46105,South Dakota,Perkins County,2964,50450,47,2106,276,133,971,2,48,121,81,40,109,101,8,96,83,13,106,93,13,19.421,5.149,4.943
46103,South Dakota,Pennington County,108126,52245,37.8,73154,14214,7405,29196,1196,1445,4633,3704,929,4591,3749,842,6118,4388,1730,6309,5030,1279,29.553,9.046,4.949
46121,South Dakota,Todd County,10016,26285,24.4,4903,515,281,1152,0,31,538,149,389,503,220,283,616,187,429,620,346,274,16.235,2.691,2.691
46127,South Dakota,Union County,14929,65434,41.1,10188,1964,1157,4601,64,198,552,441,111,486,412,74,666,599,67,679,557,122,30.634,5.694,4.303
46097,South Dakota,Miner County,2255,50658,42,1556,234,78,777,17,25,72,52,20,39,38,1,95,77,18,119,95,24,20.051,5.405,3.218
46085,South Dakota,Lyman County,3882,47113,36,2437,332,105,967,47,10,195,112,83,149,76,73,194,115,79,187,129,58,17.932,5.895,1.034
46137,South Dakota,Ziebach County,2837,35000,30.5,1574,192,42,408,0,11,169,60,109,110,63,47,166,88,78,110,80,30,14.867,2.696,2.696
46039,South Dakota,Deuel County,4282,57969,44.7,3016,458,147,1508,20,51,142,97,45,137,135,2,218,165,53,172,163,9,20.06,4.708,3.382
46115,South Dakota,Spink County,6478,52000,44.1,4477,752,229,1929,9,38,243,190,53,195,158,37,302,248,54,300,269,31,21.912,2.436,1.97
46009,South Dakota,Bon Homme County,6972,52923,43.5,5113,660,310,1925,28,13,196,162,34,184,165,19,211,187,24,236,213,23,18.971,2.13,0.675
46015,South Dakota,Brule County,5280,50870,40.5,3549,642,261,1476,53,34,222,173,49,198,175,23,247,190,57,235,196,39,25.444,5.894,2.304
46011,South Dakota,Brookings County,33697,53473,26.7,17794,4629,2564,7512,169,174,4303,3946,357,4232,3931,301,2234,1958,276,1631,1448,183,40.424,4.566,2.316
46047,South Dakota,Fall River County,6783,48862,50.9,5172,944,245,2264,47,126,154,83,71,166,114,52,265,198,67,278,248,30,22.989,7.641,5.565
46053,South Dakota,Gregory County,4209,42679,45.8,2965,509,117,1354,29,49,139,109,30,111,94,17,164,131,33,173,116,57,21.113,5.761,3.619
46057,South Dakota,Hamlin County,5911,61784,35.2,3568,597,174,1786,34,39,271,231,40,230,191,39,274,242,32,271,250,21,21.609,4.087,2.184
46102,South Dakota,Oglala Lakota County,14291,27804,25.2,7179,680,211,1536,12,0,882,289,593,905,542,363,909,226,683,968,476,492,12.411,0.781,0
47017,Tennessee,Carroll County,28137,38201,43,19385,1931,1131,8204,92,501,1398,1144,254,1344,1211,133,1282,910,372,1302,1188,114,15.796,7.228,6.107
47023,Tennessee,Chester County,17097,43740,36.2,10863,983,807,4500,126,185,1058,904,154,1048,920,128,808,526,282,908,674,234,16.478,6.911,4.111
47039,Tennessee,Decatur County,11681,36427,45.7,8390,656,310,3473,83,112,476,349,127,389,275,114,511,377,134,516,403,113,11.514,5.615,3.225
47037,Tennessee,Davidson County,678322,53419,34.3,464026,114156,67269,148731,5817,10580,35297,28043,7254,38565,32329,6236,55583,41429,14154,60196,51204,8992,39.098,11.025,7.114
47087,Tennessee,Jackson County,11573,33933,46.9,8551,409,280,3470,121,301,424,310,114,381,319,62,490,331,159,524,359,165,8.058,12.161,8.674
47109,Tennessee,McNairy County,25945,34353,42.7,18111,1497,720,7428,167,361,955,708,247,1081,672,409,1220,763,457,1229,903,326,12.241,7.108,4.86
47135,Tennessee,Perry County,7882,31503,43.5,5578,400,204,2700,27,219,275,192,83,277,166,111,413,342,71,349,306,43,10.828,9.111,8.111
47145,Tennessee,Roane County,52926,45407,46.5,38880,4461,3057,16274,310,761,1712,1328,384,1974,1583,391,2353,1616,737,2428,1927,501,19.336,6.581,4.676
47011,Tennessee,Bradley County,103666,46381,39.2,70006,9433,5814,26120,755,1643,4865,3623,1242,5005,4228,777,5613,3992,1621,5694,4556,1138,21.78,9.181,6.29
47121,Tennessee,Meigs County,11830,39786,44.4,8549,419,420,3816,121,253,441,373,68,433,362,71,453,333,120,551,501,50,9.814,9.801,6.63
47063,Tennessee,Hamblen County,63465,42042,40.3,43565,4580,2575,16081,395,852,2736,1811,925,2339,1851,488,3084,1932,1152,3294,2518,776,16.424,7.754,5.298
47075,Tennessee,Haywood County,17944,36118,40,12427,966,570,4258,175,184,751,625,126,482,422,60,700,633,67,1257,1135,122,12.36,8.431,4.321
47083,Tennessee,Houston County,8188,41820,43.6,5714,474,140,2315,82,137,331,199,132,235,164,71,395,238,157,428,391,37,10.746,9.46,5.918
47119,Tennessee,Maury County,87606,52080,38.9,60140,8403,4027,22891,810,1480,3408,2486,922,3407,2794,613,4963,3864,1099,5553,4886,667,20.668,10.004,6.465
47173,Tennessee,Union County,19176,40132,42,13463,729,455,5492,123,227,792,600,192,656,540,116,847,598,249,1045,795,250,8.794,6.373,4.133
47071,Tennessee,Hardin County,25813,39092,45.3,18652,1568,836,7596,192,378,1019,681,338,884,793,91,1096,854,242,1118,1008,110,12.889,7.504,4.976
47125,Tennessee,Montgomery County,192120,53737,30.5,117962,21201,9745,40631,1491,2787,9652,7555,2097,11187,9431,1756,11553,8972,2581,14990,13020,1970,26.234,10.529,6.859
47043,Tennessee,Dickson County,51341,47398,39.5,35020,3379,1761,13571,417,752,2067,1488,579,2280,1648,632,2455,1948,507,2736,2311,425,14.677,8.614,5.541
47129,Tennessee,Morgan County,21639,40707,41.2,15609,742,457,5994,104,369,795,559,236,644,490,154,802,579,223,935,826,109,7.681,7.891,6.156
47061,Tennessee,Grundy County,13359,31919,43,9312,647,375,3670,104,234,519,289,230,476,310,166,633,261,372,689,531,158,10.975,9.21,6.376
47123,Tennessee,Monroe County,45698,36931,43,32041,2407,1352,13198,379,984,1582,1284,298,1800,1506,294,2216,1730,486,2187,1820,367,11.732,10.327,7.456
47079,Tennessee,Henry County,32263,40415,45.3,23243,2074,1612,10173,189,550,1193,873,320,1074,948,126,1295,796,499,1559,1347,212,15.859,7.264,5.406
47029,Tennessee,Cocke County,35262,32027,44.7,25364,1793,1097,9964,252,696,1254,902,352,1253,913,340,1658,1254,404,1845,1495,350,11.394,9.514,6.985
47033,Tennessee,Crockett County,14554,39692,40,9854,805,477,3770,104,206,501,367,134,558,424,134,785,524,261,854,648,206,13.01,8.223,5.464
47041,Tennessee,DeKalb County,19380,40690,40.9,13623,1214,640,4896,125,290,809,699,110,699,646,53,1084,725,359,918,747,171,13.609,8.476,5.923
47095,Tennessee,Lake County,7588,31993,40.2,5666,306,227,1284,63,89,282,197,85,156,132,24,193,152,41,305,233,72,9.407,11.838,6.931
47093,Tennessee,Knox County,452286,52458,37.3,300733,66004,43795,116893,3013,6231,27620,23794,3826,27326,24100,3226,26190,20529,5661,27617,23811,3806,36.51,7.908,5.331
47101,Tennessee,Lewis County,11944,37092,44.7,8530,711,313,3674,105,98,459,311,148,427,348,79,501,352,149,609,524,85,12.005,5.525,2.667
47107,Tennessee,McMinn County,52569,39990,42.6,36911,3647,2023,15115,290,1057,2118,1548,570,2055,1791,264,2489,1747,742,2734,2356,378,15.361,8.912,6.993
47117,Tennessee,Marshall County,31753,46837,39.3,21771,2104,820,8608,210,647,1184,984,200,1241,947,294,1638,1280,358,1806,1361,445,13.431,9.956,7.516
47131,Tennessee,Obion County,30659,38063,42.6,21400,2179,1162,8631,229,421,1147,877,270,1244,951,293,1336,993,343,1458,1247,211,15.612,7.531,4.878
47143,Tennessee,Rhea County,32478,39368,40.7,22093,2011,1124,8882,275,262,1458,1142,316,1438,1252,186,1469,1150,319,1707,1393,314,14.19,6.046,2.95
47151,Tennessee,Scott County,21949,31875,38.7,14877,650,592,5941,234,386,833,544,289,910,834,76,1193,807,386,1110,926,184,8.348,10.436,6.497
47167,Tennessee,Tipton County,61434,57212,37.3,40435,3826,2363,14831,519,692,2925,2153,772,2459,2025,434,3165,2350,815,3436,3016,420,15.306,8.165,4.666
47001,Tennessee,Anderson County,75538,47206,43.3,53674,7217,5536,20584,342,1132,3167,2374,793,2876,2538,338,3732,2895,837,4020,3233,787,23.76,7.161,5.499
47045,Tennessee,Dyer County,37751,44386,40.5,25448,2959,1645,9428,346,465,1524,1080,444,1437,1187,250,1794,1504,290,2031,1803,228,18.092,8.602,4.932
47049,Tennessee,Fentress County,17940,32616,44.8,12735,936,558,5580,202,234,605,432,173,697,584,113,862,618,244,726,574,152,11.731,7.814,4.194
47053,Tennessee,Gibson County,49222,41315,40.3,33168,3751,2147,13438,393,726,2214,1721,493,2085,1848,237,2068,1563,505,2552,2301,251,17.782,8.327,5.403
47065,Tennessee,Hamilton County,354589,50273,39.5,247228,48601,26723,89631,2574,4934,16465,13222,3243,17235,15038,2197,20974,15973,5001,22296,19008,3288,30.467,8.377,5.505
47069,Tennessee,Hardeman County,25784,36686,40.5,18313,1233,766,6039,261,276,1207,837,370,1035,696,339,1064,841,223,954,865,89,10.916,8.892,4.57
47105,Tennessee,Loudon County,51024,55431,47.1,37341,5991,3788,15282,476,749,1757,1310,447,1852,1467,385,2263,1340,923,2171,1650,521,26.188,8.016,4.901
47139,Tennessee,Polk County,16722,42307,44.9,12097,798,513,5355,116,297,657,558,99,588,528,60,682,536,146,737,623,114,10.837,7.712,5.546
47149,Tennessee,Rutherford County,298456,62149,33.1,185540,41285,17739,69934,1936,3705,18858,15687,3171,18815,16486,2329,19260,15060,4200,19412,16781,2631,31.812,8.066,5.298
47159,Tennessee,Smith County,19279,44275,41.2,13197,903,573,5633,175,359,665,608,57,743,634,109,992,804,188,931,808,123,11.184,9.48,6.373
47185,Tennessee,White County,26394,37654,43.4,18577,1511,782,7673,232,431,1038,557,481,868,740,128,1391,1152,239,1291,963,328,12.343,8.641,5.617
47189,Tennessee,Wilson County,128874,66123,40.2,88039,18391,7744,36338,1264,2530,4984,4191,793,4427,4118,309,6258,5211,1047,6957,6301,656,29.686,10.441,6.962
47163,Tennessee,Sullivan County,156519,42251,44.7,113348,15032,9858,48178,1242,2404,6111,4621,1490,6220,5367,853,7224,5196,2028,7379,6238,1141,21.959,7.568,4.99
47171,Tennessee,Unicoi County,17830,36576,45.9,13171,1329,633,5513,198,258,629,406,223,673,491,182,991,668,323,721,655,66,14.896,8.271,4.68
47177,Tennessee,Warren County,40210,36765,40.1,27431,2352,1586,10794,289,554,1682,1220,462,1483,1306,177,1974,1397,577,2221,1861,360,14.356,7.81,5.132
47179,Tennessee,Washington County,126437,44180,39.8,86310,16158,11356,34063,1051,1695,7134,5602,1532,7978,6704,1274,6873,5368,1505,6648,5782,866,31.878,8.062,4.976
47183,Tennessee,Weakley County,33776,36550,38.1,21476,2868,1605,9060,124,280,2524,2069,455,2587,2364,223,1712,1375,337,1506,1295,211,20.828,4.459,3.091
47005,Tennessee,Benton County,16154,33702,46.5,11827,976,541,5066,205,317,496,360,136,643,517,126,678,473,205,610,496,114,12.827,10.304,6.257
47007,Tennessee,Bledsoe County,14413,40450,44.5,10989,791,570,3533,36,149,548,375,173,412,324,88,957,629,328,501,397,104,12.385,5.236,4.217
47013,Tennessee,Campbell County,39824,35377,43.5,28593,2115,1249,10980,311,645,1571,966,605,1590,1256,334,1809,1114,695,1944,1556,388,11.765,8.707,5.874
47015,Tennessee,Cannon County,13839,47457,41.7,9834,791,406,4015,125,123,595,452,143,476,441,35,797,643,154,772,650,122,12.172,6.177,3.064
47031,Tennessee,Coffee County,54074,46614,40.2,36721,4414,2537,14625,329,806,1992,1707,285,2077,1755,322,2876,1981,895,3187,2786,401,18.929,7.761,5.511
47047,Tennessee,Fayette County,39336,57919,44.8,28528,4233,2164,12028,357,869,1421,1297,124,1268,1144,124,1859,1262,597,2107,1735,372,22.424,10.193,7.225
47067,Tennessee,Hancock County,6605,29619,44.6,4776,273,214,2094,40,89,277,190,87,302,267,35,273,201,72,302,292,10,10.197,6.16,4.25
47073,Tennessee,Hawkins County,56402,38728,44.2,40470,3582,1744,17302,343,1041,2052,1462,590,2148,1821,327,2697,1915,782,2679,2242,437,13.16,7.999,6.017
47091,Tennessee,Johnson County,17846,32994,45.7,13489,1029,438,5305,161,227,632,479,153,601,430,171,799,570,229,665,590,75,10.876,7.314,4.279
47103,Tennessee,Lincoln County,33543,42153,43.3,23620,2865,1449,9904,348,543,1326,977,349,1040,882,158,1466,1008,458,1666,1481,185,18.264,8.996,5.483
47111,Tennessee,Macon County,23239,35533,38.6,15655,871,636,6723,133,496,998,782,216,971,810,161,1189,818,371,1467,1160,307,9.626,9.356,7.378
47127,Tennessee,Moore County,6302,51671,45.1,4566,595,294,2195,31,163,228,203,25,254,186,68,269,233,36,253,199,54,19.47,8.838,7.426
47147,Tennessee,Robertson County,68575,57424,38.7,46223,5617,2755,18748,494,1110,2668,2151,517,2616,2383,233,3836,2998,838,3917,3403,514,18.112,8.556,5.921
47051,Tennessee,Franklin County,41397,46882,41.5,28183,3446,2350,12015,286,701,2141,2029,112,2343,2120,223,1932,1520,412,1873,1510,363,20.566,8.215,5.834
47009,Tennessee,Blount County,127135,51172,43.2,90409,13897,7218,37372,1102,2260,5434,4317,1117,4956,4087,869,5807,4507,1300,6482,5430,1052,23.355,8.996,6.047
47021,Tennessee,Cheatham County,39713,56150,40.5,27319,3514,1787,11599,505,720,1611,1381,230,1578,1361,217,2070,1446,624,2097,1768,329,19.404,10.561,6.207
47019,Tennessee,Carter County,56500,34625,44.4,41355,4166,2232,16656,423,1185,2122,1511,611,2162,1777,385,3008,2089,919,2921,2334,587,15.471,9.654,7.115
47057,Tennessee,Grainger County,22942,40088,44.2,16468,1269,557,7061,183,380,744,571,173,801,699,102,1209,822,387,1086,840,246,11.088,7.973,5.382
47055,Tennessee,Giles County,29024,43925,43.1,20447,1973,1047,8086,279,308,1153,892,261,1314,1174,140,1283,1055,228,1439,1294,145,14.77,7.259,3.809
47097,Tennessee,Lauderdale County,26497,35551,38,17960,954,589,5590,205,380,921,724,197,1040,921,119,1084,769,315,1333,1185,148,8.591,10.465,6.798
47099,Tennessee,Lawrence County,42591,41522,39.6,28675,2035,1469,11887,205,687,1556,989,567,1676,1229,447,2161,1719,442,2217,1714,503,12.22,7.504,5.779
47113,Tennessee,Madison County,97887,44496,37.9,64697,11038,5859,23511,792,1526,4818,3750,1068,5449,4877,572,4941,3917,1024,5752,4935,817,26.117,9.859,6.491
47115,Tennessee,Marion County,28355,45366,43.2,20220,1716,914,8511,252,514,949,852,97,1039,832,207,1474,1086,388,1493,1234,259,13.007,9,6.039
47133,Tennessee,Overton County,21995,36052,42.6,15314,1298,694,7028,189,381,852,565,287,667,586,81,926,635,291,1103,951,152,13.008,8.11,5.421
47137,Tennessee,Pickett County,5071,39313,49.8,3950,185,91,1771,52,36,111,55,56,205,162,43,244,174,70,136,136,0,6.987,4.969,2.033
47165,Tennessee,Sumner County,175730,61584,39.6,119289,21302,10358,47485,1852,2704,7058,5467,1591,6711,5900,811,9010,7157,1853,9983,8685,1298,26.541,9.595,5.694
47181,Tennessee,Wayne County,16713,34299,41.9,12263,781,578,4715,118,381,635,524,111,500,428,72,835,672,163,700,581,119,11.082,10.583,8.081
47169,Tennessee,Trousdale County,8773,41776,37.5,5999,645,268,2101,55,189,605,274,331,315,315,0,652,491,161,536,448,88,15.219,11.614,8.996
47187,Tennessee,Williamson County,212161,103543,39,137338,50465,29337,58932,1709,3035,6961,5898,1063,6808,6215,593,8621,7635,986,9594,8723,871,58.106,8.05,5.15
47003,Tennessee,Bedford County,46854,47117,37.2,30826,3360,1465,11631,379,1064,1953,1563,390,1834,1661,173,2790,1983,807,2916,2336,580,15.652,12.406,9.148
47027,Tennessee,Clay County,7684,30801,47.6,5600,368,347,2359,63,128,221,161,60,319,278,41,370,268,102,281,206,75,12.768,8.097,5.426
47059,Tennessee,Greene County,68520,38266,44.3,49161,4743,2615,19864,433,1043,2874,2245,629,2641,2058,583,2973,2206,767,3253,2706,547,14.967,7.431,5.251
47035,Tennessee,Cumberland County,58178,40994,50.5,44068,5237,2952,19627,472,1218,1926,1164,762,1712,1506,206,2437,1614,823,2571,1925,646,18.583,8.611,6.206
47157,Tennessee,Shelby County,937847,48415,35.3,607366,113166,72549,195204,7503,16324,45172,33900,11272,47673,38146,9527,54810,37748,17062,61434,50857,10577,30.577,12.206,8.363
47175,Tennessee,Van Buren County,5675,43631,47.2,4160,211,200,1888,36,134,173,59,114,189,115,74,167,102,65,187,142,45,9.88,9.004,7.097
47025,Tennessee,Claiborne County,31566,35428,42.7,22478,1679,1240,9234,179,649,1468,1266,202,1554,1286,268,1558,1291,267,1576,1451,125,12.986,8.967,7.028
47077,Tennessee,Henderson County,27889,42711,41.2,19337,1904,873,7831,168,291,969,761,208,979,896,83,1252,1095,157,1711,1372,339,14.361,5.861,3.716
47081,Tennessee,Hickman County,24502,39333,40.9,17137,1196,685,6998,254,399,851,768,83,987,735,252,1199,730,469,1043,766,277,10.976,9.331,5.702
47085,Tennessee,Humphreys County,18281,40998,42.1,12890,921,695,5432,193,271,634,440,194,746,624,122,920,789,131,902,865,37,12.537,8.542,4.989
47089,Tennessee,Jefferson County,52887,45641,43.2,37176,3653,2379,14751,554,790,2300,1784,516,2382,2036,346,2462,1786,676,2645,2228,417,16.226,9.111,5.356
47141,Tennessee,Putnam County,75565,37802,36,48159,7615,4326,18527,653,1520,6187,4838,1349,4829,4085,744,3890,2869,1021,4305,3683,622,24.795,11.729,8.204
47153,Tennessee,Sequatchie County,14654,51312,43,10320,882,613,4153,148,282,515,408,107,421,401,20,611,485,126,833,708,125,14.486,10.354,6.79
47155,Tennessee,Sevier County,95523,44473,42.4,67341,7853,4259,24861,926,1620,4501,3327,1174,3708,2850,858,4595,2853,1742,5230,3499,1731,17.986,10.241,6.516
47161,Tennessee,Stewart County,13248,44090,43.6,9417,909,515,3769,58,297,473,362,111,407,407,0,577,376,201,643,567,76,15.122,9.419,7.88
48199,Texas,Hardin County,55993,56131,39.3,37590,4357,1943,16757,321,646,2395,1619,776,2331,1807,524,2983,2099,884,3234,2343,891,16.76,5.771,3.855
48207,Texas,Haskell County,5806,43529,43.4,4333,377,155,1655,25,28,237,149,88,101,50,51,237,194,43,197,127,70,12.278,3.202,1.692
48227,Texas,Howard County,36491,50855,36.7,24729,2271,911,7508,173,159,1730,1408,322,1709,1289,420,1854,1317,537,1784,1388,396,12.867,4.422,2.118
48289,Texas,Leon County,16966,44875,44.7,11682,1381,474,4897,48,206,713,328,385,517,281,236,584,377,207,686,365,321,15.879,5.187,4.207
48333,Texas,Mills County,4887,46318,47.3,3346,502,267,1553,52,77,129,82,47,127,94,33,83,48,35,226,177,49,22.983,8.307,4.958
48337,Texas,Montague County,19406,46592,44,13601,1461,747,5784,126,268,548,321,227,780,458,322,1012,710,302,828,619,209,16.234,6.812,4.633
48351,Texas,Newton County,14187,40180,43.5,9862,668,204,3957,85,112,620,340,280,401,307,94,858,620,238,587,478,109,8.842,4.979,2.83
48365,Texas,Panola County,23574,49704,38.7,15842,1599,726,6995,153,319,862,606,256,1110,844,266,1278,915,363,1064,691,373,14.676,6.748,4.56
48389,Texas,Reeves County,14791,49390,35.4,9773,683,250,2674,9,6,848,725,123,440,318,122,912,693,219,675,418,257,9.547,0.561,0.224
48403,Texas,Sabine County,10429,33561,52.1,8040,749,410,3353,27,154,439,256,183,98,93,5,503,144,359,557,319,238,14.415,5.398,4.593
48421,Texas,Sherman County,3067,54961,39.8,2077,340,105,860,34,20,114,67,47,103,60,43,174,123,51,152,97,55,21.425,6.279,2.326
48437,Texas,Swisher County,7541,37883,35.6,5034,507,146,1814,64,83,300,111,189,277,177,100,379,251,128,417,267,150,12.972,8.104,4.576
48231,Texas,Hunt County,90322,49319,37.9,59772,7264,4140,22146,651,1373,4272,3082,1190,4081,2838,1243,4760,3269,1491,4994,3277,1717,19.079,9.139,6.2
48063,Texas,Camp County,12670,41811,36.8,8177,964,399,3345,55,135,568,324,244,556,285,271,770,612,158,621,445,176,16.669,5.68,4.036
48195,Texas,Hansford County,5532,40678,34.9,3408,426,117,1404,7,21,305,215,90,219,145,74,259,198,61,328,215,113,15.933,1.994,1.496
48187,Texas,Guadalupe County,150889,66187,36.7,98048,17245,9051,39219,861,1973,6309,4606,1703,6411,4795,1616,8479,6505,1974,8436,6468,1968,26.82,7.226,5.031
48077,Texas,Clay County,10369,46863,46,7446,953,379,3479,56,99,406,301,105,334,171,163,378,219,159,480,386,94,17.889,4.455,2.846
48205,Texas,Hartley County,5821,64427,39.8,4340,561,178,1067,11,60,151,131,20,132,125,7,181,126,55,270,154,116,17.028,6.654,5.623
48217,Texas,Hill County,35098,45970,42.5,23911,2628,1293,9350,227,418,1490,994,496,1270,799,471,1552,1082,470,1756,1325,431,16.398,6.898,4.471
48293,Texas,Limestone County,23480,40356,39.5,16048,1572,645,6109,185,368,1046,596,450,747,468,279,1423,624,799,1127,737,390,13.815,9.052,6.024
48347,Texas,Nacogdoches County,65411,41482,30.6,37299,5756,3649,13308,475,575,5413,3800,1613,6473,4595,1878,3243,2093,1150,3391,2153,1238,25.215,7.89,4.321
48369,Texas,Parmer County,9871,50410,34.1,6073,747,230,2221,82,104,415,199,216,371,286,85,688,401,287,568,333,235,16.088,8.375,4.683
48367,Texas,Parker County,125963,70608,39.6,84550,16056,6727,34062,738,1905,4894,3633,1261,4664,3575,1089,6089,4580,1509,6592,5110,1482,26.946,7.759,5.593
48377,Texas,Presidio County,7191,26486,41.4,4517,608,306,1543,30,14,209,88,121,157,100,57,214,147,67,248,78,170,20.235,2.852,0.907
48465,Texas,Val Verde County,48976,44609,31.7,29286,3772,1521,9592,215,343,2128,1015,1113,2252,1228,1024,2749,1784,965,2761,1783,978,18.073,5.817,3.576
48109,Texas,Culberson County,2257,33125,41.2,1567,104,37,490,0,10,107,95,12,72,52,20,111,53,58,183,118,65,8.998,2.041,2.041
48135,Texas,Ector County,155744,59528,30.3,92135,10084,3775,33994,869,1653,9248,5809,3439,8092,5427,2665,11708,8047,3661,10662,7194,3468,15.042,7.419,4.863
48169,Texas,Garza County,6739,53832,40.1,5062,412,104,1115,11,0,168,168,0,110,92,18,256,152,104,262,178,84,10.194,0.987,0
48173,Texas,Glasscock County,1420,64886,38.3,936,187,50,341,2,0,67,52,15,63,47,16,100,10,90,23,23,0,25.321,0.587,0
48185,Texas,Grimes County,27358,49745,40.4,18776,1703,874,6983,143,467,950,853,97,823,519,304,1070,686,384,1125,803,322,13.725,8.736,6.688
48453,Texas,Travis County,1176584,68350,33.6,795223,240380,136996,234225,8971,17090,62328,47270,15058,61734,48305,13429,107139,79672,27467,100872,79971,20901,47.455,11.126,7.296
48085,Texas,Collin County,914075,90124,36.5,594927,194541,108514,212556,6427,12478,36104,27470,8634,34137,27728,6409,51275,40392,10883,55030,45700,9330,50.94,8.894,5.87
48005,Texas,Angelina County,87700,46472,36.8,56963,6426,3111,20424,355,935,4015,2678,1337,3912,2671,1241,4432,2849,1583,5147,3471,1676,16.742,6.316,4.578
48087,Texas,Collingsworth County,3026,46348,39.8,2062,221,101,883,2,32,119,76,43,108,102,6,159,65,94,178,91,87,15.616,3.851,3.624
48101,Texas,Cottle County,1498,33534,47.6,1061,114,63,434,5,8,23,15,8,12,5,7,35,7,28,97,56,41,16.682,2.995,1.843
48209,Texas,Hays County,194843,62815,31.3,115173,27823,14296,42242,1464,2832,16052,12485,3567,16044,12781,3263,12335,8942,3393,11903,9374,2529,36.57,10.17,6.704
48279,Texas,Lamb County,13368,43712,35.6,8451,945,444,3399,13,83,489,353,136,508,282,226,789,396,393,781,474,307,16.436,2.824,2.442
48295,Texas,Lipscomb County,3495,59583,35,2266,314,112,935,15,32,155,144,11,141,101,40,280,219,61,182,116,66,18.8,5.027,3.422
48301,Texas,Loving County,74,80938,57.5,64,3,0,16,0,0,3,3,0,0,0,0,0,0,0,0,0,0,4.688,0,0
48321,Texas,Matagorda County,36744,44896,37.2,23972,2547,980,9359,177,378,1559,995,564,1547,1003,544,1935,1114,821,2077,1192,885,14.713,5.93,4.039
48371,Texas,Pecos County,15804,50543,36.2,10631,696,329,3075,56,40,703,385,318,636,366,270,846,569,277,687,501,186,9.642,3.122,1.301
48395,Texas,Robertson County,16727,52189,41.4,11278,1170,526,4691,35,188,687,324,363,638,479,159,650,506,144,915,631,284,15.038,4.754,4.008
48397,Texas,Rockwall County,90414,93269,37.2,58304,15356,7947,24414,959,1567,3595,2590,1005,3159,2546,613,4359,3645,714,4918,4203,715,39.968,10.347,6.418
48401,Texas,Rusk County,53026,49270,38.5,36180,3855,1748,13677,287,553,1953,1206,747,1821,1172,649,2539,1690,849,2641,1853,788,15.486,6.142,4.043
48441,Texas,Taylor County,135371,49161,32.2,82140,13250,6517,29152,738,1024,7996,6232,1764,9316,7256,2060,7824,5729,2095,8334,6311,2023,24.065,6.044,3.513
48447,Texas,Throckmorton County,1541,37279,48.2,1116,178,45,520,6,5,60,40,20,60,52,8,60,49,11,67,38,29,19.982,2.115,0.962
48455,Texas,Trinity County,14481,37398,48.5,10599,878,365,4616,75,149,449,225,224,406,228,178,574,444,130,611,378,233,11.728,4.853,3.228
48471,Texas,Walker County,70818,41456,35.2,45996,6546,2770,11241,214,392,6028,4605,1423,6097,5408,689,3310,2355,955,3196,2500,696,20.254,5.391,3.487
48499,Texas,Wood County,43315,48038,48.1,31470,3719,1309,12965,208,700,1638,1213,425,1501,1136,365,1655,1055,600,1679,794,885,15.977,7.003,5.399
48019,Texas,Bandera County,21316,56413,52,16297,2588,1287,7007,227,273,670,436,234,591,494,97,715,332,383,833,524,309,23.777,7.136,3.896
48007,Texas,Aransas County,24832,44601,49.6,18258,2251,1309,7039,234,401,893,432,461,814,432,382,1078,693,385,917,686,231,19.498,9.021,5.697
48075,Texas,Childress County,7064,40432,32.8,4763,581,301,1254,28,78,255,218,37,171,129,42,388,312,76,464,303,161,18.518,8.453,6.22
48079,Texas,Cochran County,2932,37500,33.5,1820,125,67,761,6,6,116,19,97,100,38,62,209,139,70,218,119,99,10.549,1.577,0.788
48081,Texas,Coke County,3238,42500,49.1,2406,336,159,1121,4,26,113,104,9,52,41,11,50,37,13,117,99,18,20.574,2.676,2.319
48091,Texas,Comal County,129100,73655,42.2,89549,21295,10924,35605,968,1962,4661,3477,1184,4451,3289,1162,6252,4733,1519,6452,4879,1573,35.979,8.229,5.51
48099,Texas,Coryell County,75818,50865,31.2,47102,5159,2082,12916,264,656,1831,1239,592,3268,2819,449,3297,2354,943,4740,3915,825,15.373,7.123,5.079
48211,Texas,Hemphill County,4152,68679,35.1,2488,482,83,929,0,0,154,133,21,116,102,14,175,143,32,168,100,68,22.709,0,0
48225,Texas,Houston County,22849,33552,44.6,16647,1830,580,5721,150,342,874,606,268,736,500,236,775,549,226,983,783,200,14.477,8.6,5.978
48341,Texas,Moore County,22016,52469,30.5,12664,1327,365,4294,72,64,1271,972,299,1138,756,382,1413,1082,331,1210,866,344,13.361,3.167,1.49
48349,Texas,Navarro County,48239,45103,38.9,31447,3170,1740,11889,335,632,1892,1105,787,1946,1090,856,2313,1217,1096,2648,1682,966,15.614,8.134,5.316
48375,Texas,Potter County,121230,41852,33.6,76469,7824,3482,24906,803,1498,6027,3752,2275,5789,3721,2068,7731,4534,3197,7435,4709,2726,14.785,9.239,6.015
48405,Texas,San Augustine County,8403,32394,48.9,6140,531,213,2537,19,61,181,142,39,231,121,110,377,183,194,401,320,81,12.117,3.153,2.404
48415,Texas,Scurry County,17346,54565,35.6,11184,1258,601,4327,142,121,615,488,127,697,493,204,801,655,146,886,620,266,16.622,6.078,2.796
48417,Texas,Shackelford County,3348,46685,42,2232,449,163,992,19,33,104,77,27,130,87,43,140,96,44,118,106,12,27.419,5.242,3.327
48427,Texas,Starr County,63420,27133,28.8,34979,2467,921,12136,134,474,3490,1299,2191,3367,1613,1754,3573,1582,1991,3608,1707,1901,9.686,5.01,3.906
48433,Texas,Stonewall County,1084,46786,51.9,793,71,28,348,0,5,3,3,0,10,10,0,28,12,16,46,20,26,12.484,1.437,1.437
48461,Texas,Upton County,3575,52750,33.7,2224,145,102,954,26,20,136,91,45,124,66,58,174,147,27,243,148,95,11.106,4.822,2.096
48021,Texas,Bastrop County,80306,59185,38.8,53159,7527,3249,19911,699,1302,3097,1922,1175,3074,2145,929,4088,2788,1300,3922,2475,1447,20.271,10.05,6.539
48049,Texas,Brown County,37787,43062,41,25710,3183,1386,10038,239,496,1645,1061,584,1639,1214,425,1917,1383,534,2046,1375,671,17.771,7.322,4.941
48191,Texas,Hall County,3102,31324,43.2,2079,167,97,779,16,20,120,50,70,148,32,116,102,66,36,69,54,15,12.698,4.621,2.567
48025,Texas,Bee County,32729,45415,35.2,22180,1263,784,5375,172,182,1560,1071,489,1241,766,475,1674,1252,422,1451,959,492,9.229,6.586,3.386
48159,Texas,Franklin County,10639,43967,42.9,7185,1031,392,2929,47,287,497,235,262,364,233,131,387,315,72,518,346,172,19.805,11.403,9.799
48163,Texas,Frio County,19110,37382,31.3,11490,648,179,3174,94,178,1441,1010,431,650,534,116,690,288,402,753,357,396,7.198,8.57,5.608
48103,Texas,Crane County,4836,63935,32.1,2889,213,126,1158,0,45,190,149,41,197,145,52,303,183,120,256,194,62,11.734,3.886,3.886
48281,Texas,Lampasas County,20473,54467,41.8,14175,1871,983,5758,191,278,784,362,422,577,437,140,876,577,299,1100,874,226,20.134,8.145,4.828
48307,Texas,McCulloch County,8145,42367,43.5,5832,671,261,2398,22,77,214,108,106,344,137,207,500,317,183,165,112,53,15.981,4.128,3.211
48319,Texas,Mason County,4122,40949,48.9,3071,424,198,1185,17,70,102,52,50,158,86,72,224,80,144,84,72,12,20.254,7.342,5.907
48125,Texas,Dickens County,2224,43088,43.2,1607,158,86,595,1,14,69,51,18,41,35,6,97,36,61,72,44,28,15.184,2.521,2.353
48287,Texas,Lee County,16850,55741,41.3,11512,1414,617,4739,105,287,690,571,119,641,438,203,681,510,171,853,519,334,17.642,8.272,6.056
48439,Texas,Tarrant County,1983675,62532,34.2,1263581,264881,128378,418852,14199,24828,91793,64449,27344,94611,69164,25447,128530,89149,39381,134098,98863,35235,31.123,9.318,5.928
48001,Texas,Anderson County,57747,42313,39.1,41873,3221,1973,11748,344,442,1873,1242,631,1854,1279,575,1974,1643,331,2287,1632,655,12.404,6.691,3.762
48139,Texas,Ellis County,164092,67371,36,104692,16526,6616,39978,1059,2230,7352,5185,2167,7264,5488,1776,8864,5822,3042,9419,6365,3054,22.105,8.227,5.578
48239,Texas,Jackson County,14756,58504,39.2,9757,1301,482,3650,28,78,543,428,115,597,463,134,763,571,192,654,439,215,18.274,2.904,2.137
48265,Texas,Kerr County,50761,48698,47.8,36657,6047,3452,14660,233,719,1930,1227,703,2064,1497,567,2161,1411,750,2372,1661,711,25.913,6.494,4.905
48331,Texas,Milam County,24479,41768,41.5,16592,1860,633,6444,224,315,982,705,277,757,556,201,1245,1002,243,1313,1054,259,15.025,8.364,4.888
48093,Texas,Comanche County,13492,42419,44.4,9415,1204,546,4002,73,209,377,117,260,471,316,155,607,348,259,559,276,283,18.587,7.046,5.222
48145,Texas,Falls County,17289,38834,39.2,11990,1148,298,3931,124,176,819,371,448,551,326,225,976,614,362,785,576,209,12.06,7.632,4.477
48047,Texas,Brooks County,7251,24794,31.8,4173,412,201,1243,30,73,578,371,207,354,215,139,359,176,183,273,160,113,14.69,8.286,5.873
48015,Texas,Austin County,29292,62614,40.9,19933,3075,1368,8175,120,291,1087,655,432,1129,978,151,1407,1062,345,1280,974,306,22.29,5.028,3.56
48261,Texas,Kenedy County,564,24800,29.8,341,11,11,43,0,0,44,0,44,5,0,5,51,10,41,24,24,0,6.452,0,0
48355,Texas,Nueces County,358484,53317,35.1,231828,31165,17224,74465,2189,4014,17901,11512,6389,17950,12513,5437,22857,14620,8237,22801,15609,7192,20.873,8.33,5.39
48089,Texas,Colorado County,20913,50241,43.4,14213,2137,551,6240,144,147,807,622,185,829,622,207,973,702,271,845,735,110,18.912,4.663,2.356
48409,Texas,San Patricio County,66867,53332,35.1,42404,4160,1903,15546,448,611,3035,1817,1218,2938,1867,1071,3837,2653,1184,3773,2702,1071,14.298,6.812,3.93
48379,Texas,Rains County,11246,48308,47.6,8196,601,283,3346,42,271,332,132,200,310,189,121,566,377,189,510,337,173,10.786,9.354,8.099
48381,Texas,Randall County,130552,65564,35.6,85467,17818,8631,34303,872,1345,6589,4996,1593,6409,5273,1136,8398,6673,1725,8427,6629,1798,30.946,6.463,3.921
48385,Texas,Real County,3358,36493,54.3,2418,391,139,862,25,32,157,53,104,118,58,60,78,77,1,48,15,33,21.919,6.613,3.712
48411,Texas,San Saba County,5851,40301,40.9,4159,449,177,1438,38,68,240,149,91,56,13,43,298,174,124,147,66,81,15.052,7.371,4.729
48413,Texas,Schleicher County,3122,63432,35.2,1963,305,93,847,10,10,170,121,49,134,56,78,171,127,44,154,95,59,20.275,2.361,1.181
48431,Texas,Sterling County,1139,50000,42.4,779,103,64,393,0,14,31,18,13,22,9,13,69,44,25,34,26,8,21.438,3.562,3.562
48507,Texas,Zavala County,12152,25988,30.8,6946,388,142,2452,56,106,800,318,482,613,338,275,625,467,158,592,349,243,7.63,6.607,4.323
48057,Texas,Calhoun County,21821,58788,37.7,14444,1587,756,5458,129,177,836,519,317,904,699,205,1385,913,472,1195,814,381,16.221,5.606,3.243
48065,Texas,Carson County,6033,67010,41.1,4056,753,432,1948,40,40,137,88,49,273,206,67,300,243,57,323,243,80,29.216,4.107,2.053
48155,Texas,Foard County,1414,50000,48.6,1040,133,41,451,22,12,39,20,19,37,27,10,30,30,0,36,30,6,16.731,7.539,2.661
48161,Texas,Freestone County,19646,45890,40.6,13711,1200,407,5409,191,240,680,431,249,681,502,179,939,607,332,886,531,355,11.721,7.968,4.437
48175,Texas,Goliad County,7510,56737,46.4,5213,603,317,2256,31,26,238,193,45,358,277,81,234,178,56,262,156,106,17.648,2.527,1.152
48193,Texas,Hamilton County,8220,46611,46.4,5868,982,354,2389,20,45,319,62,257,230,149,81,358,266,92,336,244,92,22.768,2.721,1.884
48197,Texas,Hardeman County,3990,37995,43.6,2797,301,103,1150,2,38,187,116,71,99,57,42,199,105,94,255,178,77,14.444,3.478,3.304
48335,Texas,Mitchell County,8774,52194,34.6,5961,545,160,2005,0,44,190,122,68,240,223,17,290,201,89,411,367,44,11.827,2.195,2.195
48449,Texas,Titus County,32664,46980,34,19787,2192,938,7163,180,435,1639,882,757,1585,1092,493,1595,1119,476,1873,1010,863,15.818,8.586,6.073
48045,Texas,Briscoe County,1591,42500,46.4,1136,197,52,504,3,3,101,70,31,36,14,22,63,39,24,69,45,24,21.919,1.19,0.595
48285,Texas,Lavaca County,19859,51708,43.9,13710,1742,644,5801,74,192,800,506,294,646,434,212,876,677,199,924,713,211,17.403,4.585,3.31
48291,Texas,Liberty County,79884,48344,35.8,52195,3474,1391,19440,351,1093,3147,2134,1013,3078,2141,937,4576,2539,2037,3656,2244,1412,9.321,7.428,5.622
48445,Texas,Terry County,12755,42441,34.6,8153,696,349,2894,10,65,573,285,288,376,114,262,727,430,297,774,430,344,12.817,2.592,2.246
48497,Texas,Wise County,63247,59081,38.5,42293,5397,1859,16642,502,689,2519,1715,804,2260,1666,594,3493,2655,838,3429,2320,1109,17.157,7.157,4.14
48143,Texas,Erath County,41016,47013,30,23213,4288,2158,8803,228,470,3882,2784,1098,4441,3761,680,2217,1210,1007,2124,1522,602,27.769,7.929,5.339
48039,Texas,Brazoria County,345995,76426,35.6,224410,42804,23927,84216,2223,3892,14198,10130,4068,13757,10751,3006,20685,15972,4713,21390,16888,4502,29.736,7.261,4.621
48345,Texas,Motley County,1114,40598,37.6,742,92,24,336,16,9,63,16,47,22,15,7,96,43,53,60,32,28,15.633,7.44,2.679
48129,Texas,Donley County,3433,44429,41.9,2250,290,136,915,5,30,254,174,80,175,148,27,130,56,74,126,83,43,18.933,3.825,3.279
48013,Texas,Atascosa County,48139,55194,35.4,30432,2926,1414,11537,212,307,2292,1584,708,2003,1383,620,2661,1714,947,2823,1909,914,14.261,4.499,2.661
48083,Texas,Coleman County,8422,40804,46.6,6131,639,241,2467,46,73,279,127,152,213,85,128,440,148,292,328,141,187,14.353,4.824,2.959
48353,Texas,Nolan County,14990,42019,38.8,9757,948,349,3845,48,164,693,335,358,505,273,232,742,509,233,791,596,195,13.293,5.514,4.265
48229,Texas,Hudspeth County,3702,26346,38.8,2455,169,18,665,5,31,60,40,20,114,61,53,133,94,39,155,76,79,7.617,5.414,4.662
48325,Texas,Medina County,48548,59305,38.8,32337,4251,2228,12448,209,757,1991,1195,796,1634,1339,295,2201,1575,626,2390,1668,722,20.036,7.76,6.081
48475,Texas,Ward County,11498,63333,33.6,7213,669,306,2767,27,107,627,417,210,436,232,204,701,474,227,718,470,248,13.517,4.843,3.867
48213,Texas,Henderson County,79687,44888,43.8,55862,6711,3403,22968,593,1212,3032,1816,1216,2839,2066,773,3658,1952,1706,3876,2519,1357,18.105,7.859,5.277
48203,Texas,Harrison County,66606,48644,37.7,43624,5859,2345,17328,306,743,2820,1573,1247,2882,2340,542,3314,2488,826,3687,2735,952,18.806,6.054,4.288
48327,Texas,Menard County,2123,37917,49.1,1638,170,88,643,12,4,81,23,58,34,9,25,133,22,111,85,48,37,15.751,2.488,0.622
48277,Texas,Lamar County,49401,42198,40.4,33509,4006,1716,12273,173,567,2131,1372,759,2046,1390,656,2347,1413,934,2669,1592,1077,17.076,6.029,4.62
48149,Texas,Fayette County,24963,56941,47.2,17974,2412,833,7552,158,189,889,699,190,936,737,199,941,792,149,1082,889,193,18.054,4.595,2.503
48491,Texas,Williamson County,508313,79123,35.8,332250,89380,44333,117210,4042,6537,19618,16118,3500,19638,15917,3721,30787,24563,6224,32446,27518,4928,40.245,9.026,5.577
48267,Texas,Kimble County,4432,41095,52.6,3330,388,254,1458,40,76,86,65,21,122,43,79,110,60,50,157,95,62,19.279,7.956,5.213
48317,Texas,Martin County,5547,71115,31.7,3257,448,223,1261,12,67,270,198,72,259,171,88,344,246,98,238,192,46,20.602,6.265,5.313
48373,Texas,Polk County,46974,43267,43.4,33538,3086,1025,13523,317,640,1861,1257,604,1476,1039,437,2165,1403,762,1948,1166,782,12.258,7.077,4.733
48391,Texas,Refugio County,7293,50338,42.3,4936,438,158,1947,0,13,381,253,128,244,116,128,267,231,36,360,229,131,12.075,0.668,0.668
48467,Texas,Van Zandt County,53607,50061,43.3,37033,4419,1740,14926,349,765,1917,1271,646,2034,1228,806,2397,1588,809,2401,1676,725,16.631,7.463,5.125
48055,Texas,Caldwell County,40544,51346,35.8,26065,2525,1201,8672,78,424,2273,1222,1051,1944,1304,640,2203,1313,890,2181,1398,783,14.295,5.789,4.889
48487,Texas,Wilbarger County,12972,43913,37.2,8767,1011,322,3343,85,208,465,330,135,608,515,93,792,579,213,761,428,333,15.205,8.765,6.222
48383,Texas,Reagan County,3735,59760,33,2352,179,80,823,4,38,185,81,104,151,28,123,295,180,115,200,116,84,11.012,5.103,4.617
48501,Texas,Yoakum County,8481,62500,31.7,4877,517,219,2054,16,75,273,52,221,467,282,185,555,293,262,448,282,166,15.091,4.43,3.651
48189,Texas,Hale County,34527,46012,33,20977,2324,1058,6774,66,271,1746,1225,521,1494,995,499,1907,1142,765,1861,1097,764,16.122,4.975,4.001
48419,Texas,Shelby County,25689,38121,37.4,16398,1754,747,6580,181,181,997,649,348,1151,700,451,1290,597,693,1208,687,521,15.252,5.502,2.751
48387,Texas,Red River County,12353,35356,45.6,8888,934,290,3956,65,279,466,255,211,598,428,170,541,392,149,459,354,105,13.771,8.696,7.053
48399,Texas,Runnels County,10266,41226,41.1,6993,1063,275,2714,40,35,433,225,208,350,232,118,516,404,112,478,286,192,19.133,2.763,1.29
48407,Texas,San Jacinto County,27436,43421,44.2,19122,1428,497,7812,180,527,1159,808,351,976,663,313,1037,771,266,1134,723,411,10.067,9.05,6.746
48435,Texas,Sutton County,3894,60996,40.2,2673,460,68,1073,32,55,146,106,40,92,53,39,203,140,63,191,122,69,19.753,8.108,5.126
48451,Texas,Tom Green County,116906,49662,34,74694,12276,5528,27169,655,1286,6403,3934,2469,5796,3868,1928,7631,5774,1857,7604,6208,1396,23.836,7.144,4.733
48459,Texas,Upshur County,40506,48796,40.7,27470,3255,1382,10823,314,458,1501,1102,399,1433,1065,368,1863,1311,552,2093,1458,635,16.88,7.133,4.232
48469,Texas,Victoria County,91518,55740,35.7,59263,7819,3760,21458,659,878,4324,2661,1663,4499,2772,1727,5710,3999,1711,5394,4104,1290,19.538,7.163,4.092
48473,Texas,Waller County,48443,53506,28.8,26108,3477,1544,10084,481,559,4481,2558,1923,4650,3288,1362,2247,1631,616,2125,1462,663,19.232,10.313,5.543
48481,Texas,Wharton County,41430,50145,37.3,26830,2560,1463,10269,208,430,1825,1321,504,1716,1163,553,2275,1540,735,2214,1493,721,14.994,6.213,4.187
48485,Texas,Wichita County,131778,45776,34.2,83946,12916,5870,29759,981,1517,5166,3916,1250,6792,5395,1397,6738,4952,1786,7662,5435,2227,22.379,8.394,5.098
48493,Texas,Wilson County,47205,71942,40.4,31631,4199,1963,13157,340,767,1795,1355,440,1954,1526,428,2454,1687,767,2364,1752,612,19.481,8.414,5.83
48033,Texas,Borden County,602,77708,42.1,417,116,46,183,2,0,7,7,0,7,7,0,41,41,0,38,38,0,38.849,1.093,0
48219,Texas,Hockley County,23273,49184,33.4,14313,1313,639,5533,131,157,1342,976,366,1236,846,390,1427,987,440,1364,961,403,13.638,5.205,2.838
48315,Texas,Marion County,10140,36938,49.8,7653,778,300,3528,102,165,271,178,93,309,269,40,406,233,173,453,353,100,14.086,7.568,4.677
48323,Texas,Maverick County,57471,37734,29.6,32205,2808,999,11170,253,694,3443,1679,1764,3109,1821,1288,3283,2187,1096,2986,1697,1289,11.821,8.478,6.213
48329,Texas,Midland County,159883,75815,31.8,99639,19394,7339,36750,670,1581,8198,6231,1967,7785,4690,3095,12762,9504,3258,11645,8502,3143,26.83,6.125,4.302
48181,Texas,Grayson County,126146,52683,40.2,85080,11483,5734,31863,855,1393,5563,3798,1765,5394,4118,1276,6367,4250,2117,7000,4899,2101,20.236,7.055,4.372
48297,Texas,Live Oak County,12043,51480,42.3,8735,722,262,2959,0,90,430,255,175,244,157,87,534,349,185,605,386,219,11.265,3.042,3.042
48299,Texas,Llano County,20195,50524,57.1,16163,2981,1316,6647,147,372,645,373,272,459,164,295,806,361,445,734,457,277,26.585,7.808,5.597
48363,Texas,Palo Pinto County,28109,45067,41,19131,2239,931,7331,62,355,1073,662,411,1142,724,418,1427,781,646,1372,673,699,16.57,5.688,4.842
48147,Texas,Fannin County,33787,47875,41.9,23829,2603,1264,8977,236,340,1212,863,349,1239,890,349,1569,1013,556,1422,1077,345,16.228,6.416,3.787
48255,Texas,Karnes County,15051,53051,35.3,10281,1031,378,3200,27,92,733,545,188,458,279,179,834,664,170,627,348,279,13.705,3.719,2.875
48123,Texas,DeWitt County,20474,50960,41.2,14430,1423,542,5465,55,234,515,366,149,693,594,99,995,691,304,971,692,279,13.617,5.288,4.282
48041,Texas,Brazos County,214231,43907,25.8,111064,23839,20152,35247,1125,2160,29751,25940,3811,27007,23481,3526,14382,10686,3696,13704,10454,3250,39.609,9.32,6.128
48059,Texas,Callahan County,13660,40945,43.3,9547,1080,449,4352,74,242,426,229,197,445,344,101,672,465,207,630,340,290,16.016,7.261,5.561
48067,Texas,Cass County,30118,41432,42.9,21048,2248,968,9196,200,506,920,636,284,1100,813,287,1444,1021,423,1359,872,487,15.279,7.677,5.502
48165,Texas,Gaines County,19889,58167,28.1,10902,798,420,4364,60,96,1057,676,381,923,469,454,1194,824,370,1151,598,553,11.172,3.575,2.2
48183,Texas,Gregg County,123402,47970,35.4,79339,11233,4923,26844,713,1008,6556,4413,2143,5673,4008,1665,7164,4253,2911,7711,5170,2541,20.363,6.411,3.755
48179,Texas,Gray County,22962,48314,36.7,15296,1508,451,5995,86,182,987,653,334,1088,783,305,1163,689,474,1110,809,301,12.807,4.47,3.036
48313,Texas,Madison County,13979,44004,35.2,9671,921,341,3069,125,267,285,156,129,353,264,89,289,251,38,422,293,129,13.049,12.773,8.7
48303,Texas,Lubbock County,298042,49078,30.7,174904,31162,18975,61694,1457,3138,25484,20304,5180,24442,20152,4290,18887,14213,4674,18290,13809,4481,28.665,7.448,5.086
48237,Texas,Jack County,8839,52829,40.6,6105,415,281,2524,89,65,273,180,93,230,105,125,376,312,64,352,227,125,11.4,6.101,2.575
48257,Texas,Kaufman County,114852,63926,35.7,73684,10175,5046,28175,1196,1680,4538,3247,1291,4275,3536,739,6446,4674,1772,7221,4820,2401,20.657,10.208,5.963
48259,Texas,Kendall County,40306,81023,42.4,27557,7464,3285,9975,326,651,1434,1113,321,1226,831,395,1700,1268,432,1713,1458,255,39.006,9.794,6.526
48035,Texas,Bosque County,17955,48677,46.5,12842,1596,773,5435,146,282,571,333,238,612,430,182,717,475,242,777,543,234,18.447,7.875,5.189
48153,Texas,Floyd County,5953,48767,37.1,3829,489,176,1687,5,13,289,114,175,227,102,125,250,150,100,319,196,123,17.367,1.067,0.771
48029,Texas,Bexar County,1892004,53999,33.3,1197716,208782,118777,368817,12158,22533,100585,70104,30481,97019,70846,26173,128629,89446,39183,128832,98355,30477,27.349,9.406,6.11
48017,Texas,Bailey County,7098,43523,35.2,4338,478,146,1609,0,69,321,98,223,230,127,103,288,120,168,345,205,140,14.385,4.288,4.288
48071,Texas,Chambers County,39283,74368,35.4,24857,3492,1610,11023,257,592,1706,1272,434,1618,1282,336,2179,1653,526,2438,1771,667,20.525,7.702,5.371
48023,Texas,Baylor County,3602,36157,48.1,2559,515,120,1273,6,0,130,89,41,138,69,69,102,65,37,151,142,9,24.814,0.471,0
48027,Texas,Bell County,336506,52583,30.6,202550,32377,16680,63767,2035,3804,16084,11783,4301,18049,14636,3413,20680,15913,4767,24004,19543,4461,24.22,9.157,5.965
48061,Texas,Cameron County,420201,36095,31.4,243247,29742,12145,82068,2639,4459,21276,9684,11592,21065,9910,11155,22202,10461,11741,22835,11977,10858,17.22,8.649,5.433
48121,Texas,Denton County,781321,80290,34.9,506132,148204,71260,177522,6224,9979,36112,28602,7510,36870,30217,6653,50444,39579,10865,54224,43688,10536,43.361,9.127,5.621
48361,Texas,Orange County,83909,53667,37.7,55998,6754,2035,24309,491,925,3747,2591,1156,3407,2441,966,4464,3299,1165,4886,3718,1168,15.695,5.825,3.805
48233,Texas,Hutchinson County,21704,50035,36.9,14177,1412,534,6202,156,137,957,698,259,941,649,292,1225,762,463,1181,904,277,13.726,4.724,2.209
48477,Texas,Washington County,34667,55793,42,23225,3876,1678,9398,254,278,1587,1120,467,1691,1314,377,1408,1057,351,1595,1327,268,23.914,5.661,2.958
48343,Texas,Morris County,12530,40227,42.9,8873,893,529,3732,51,137,352,257,95,378,271,107,706,605,101,733,618,115,16.026,5.038,3.671
48429,Texas,Stephens County,9365,45862,39.2,6435,712,371,2653,46,83,351,179,172,328,176,152,457,343,114,449,282,167,16.83,4.862,3.129
48495,Texas,Winkler County,7777,55000,32.6,4590,380,109,1974,25,32,463,299,164,316,239,77,367,264,103,416,305,111,10.654,2.888,1.621
48201,Texas,Harris County,4525519,57791,33.1,2864864,559393,314848,855629,28481,58555,226570,142581,83989,220571,147425,73146,329814,212627,117187,324153,228828,95325,30.516,10.172,6.844
48003,Texas,Andrews County,17577,70753,31.6,10390,663,355,3981,0,147,869,608,261,756,518,238,909,767,142,1102,847,255,9.798,3.693,3.693
48053,Texas,Burnet County,45017,57173,44,31237,4998,2523,12610,370,577,1774,1184,590,1724,1314,410,1741,1268,473,1855,1065,790,24.077,7.51,4.576
48171,Texas,Gillespie County,25939,56267,50.2,19001,4621,1734,8234,265,541,815,355,460,725,473,252,869,584,285,930,662,268,33.446,9.789,6.57
48177,Texas,Gonzales County,20558,47516,36.9,13194,1278,465,4822,60,177,982,696,286,718,456,262,1046,652,394,1115,661,454,13.211,4.915,3.671
48113,Texas,Dallas County,2552213,53626,33.3,1621762,311327,177288,457251,18993,34256,128813,77366,51447,127934,83276,44658,179802,112368,67434,182823,127593,55230,30.129,11.645,7.492
48305,Texas,Lynn County,5785,44922,38.1,3809,523,123,1475,50,55,273,182,91,182,62,120,301,197,104,302,184,118,16.96,7.119,3.729
48311,Texas,McMullen County,600,71389,42,401,49,34,143,0,12,8,3,5,23,23,0,47,39,8,8,4,4,20.698,8.392,8.392
48503,Texas,Young County,18166,46351,41.5,12231,1636,764,5530,110,133,751,581,170,564,327,237,791,447,344,863,467,396,19.622,4.394,2.405
48505,Texas,Zapata County,14415,34550,29.4,8034,651,268,3222,39,114,736,115,621,779,209,570,861,449,412,834,415,419,11.439,4.749,3.538
48251,Texas,Johnson County,160173,60458,36.9,104312,13984,5347,40981,1117,1776,6457,4619,1838,6874,4801,2073,8935,6299,2636,9044,6337,2707,18.532,7.059,4.334
48221,Texas,Hood County,55418,60275,46.8,39783,7260,3201,16373,357,739,1762,1269,493,1882,1292,590,2509,1806,703,2647,1982,665,26.295,6.694,4.514
48223,Texas,Hopkins County,35929,47832,39.6,23983,2796,1363,9209,162,285,1497,923,574,1290,905,385,1820,1092,728,1993,1240,753,17.341,4.854,3.095
48309,Texas,McLennan County,245720,46262,33.2,148119,21969,11954,51140,1587,2865,17043,13101,3942,17718,13854,3864,13454,9314,4140,13596,9956,3640,22.903,8.706,5.602
48357,Texas,Ochiltree County,10484,50120,31.7,6192,849,282,2562,15,108,453,277,176,437,224,213,643,416,227,603,457,146,18.266,4.801,4.215
48269,Texas,King County,289,56964,32.7,207,30,11,20,0,0,3,3,0,12,8,4,50,11,39,21,17,4,19.807,0,0
48275,Texas,Knox County,3753,46319,40.6,2452,383,119,1110,2,3,159,116,43,144,115,29,159,124,35,175,113,62,20.473,0.45,0.27
48073,Texas,Cherokee County,51594,44294,38,33664,4229,1866,13172,422,704,2057,1137,920,1930,1159,771,2236,1235,1001,2548,1749,799,18.105,8.548,5.345
48095,Texas,Concho County,3858,46696,41.9,2868,237,86,564,16,6,67,63,4,85,83,2,69,33,36,45,30,15,11.262,3.901,1.064
48119,Texas,Delta County,5172,42642,43.7,3591,454,170,1571,19,68,245,126,119,227,164,63,240,122,118,169,79,90,17.377,5.538,4.328
48137,Texas,Edwards County,2111,48462,49.1,1605,308,23,551,0,0,33,0,33,90,80,10,107,90,17,43,32,11,20.623,0,0
48133,Texas,Eastland County,18278,32135,43,12529,1032,562,4817,154,122,1121,928,193,745,516,229,798,312,486,888,584,304,12.722,5.73,2.533
48253,Texas,Jones County,19969,48601,38.6,14706,1315,288,4162,109,97,169,126,43,453,320,133,261,155,106,643,425,218,10.9,4.95,2.331
48243,Texas,Jeff Davis County,2236,46534,55.3,1768,326,316,809,0,10,7,7,0,39,8,31,61,29,32,94,53,41,36.312,1.236,1.236
48247,Texas,Jim Hogg County,5262,31403,35.4,3190,279,81,1205,0,30,273,200,73,195,61,134,234,84,150,236,194,42,11.285,2.49,2.49
48249,Texas,Jim Wells County,41318,41103,34.5,25713,2246,652,9447,246,275,1744,932,812,2014,1193,821,2560,1723,837,2169,1422,747,11.271,5.515,2.911
48339,Texas,Montgomery County,535187,74323,36.7,348041,77686,39677,133082,3870,7843,21525,14459,7066,20878,16917,3961,30376,21490,8886,30420,22046,8374,33.721,8.801,5.893
48111,Texas,Dallam County,7207,45580,32.1,4378,367,174,1450,25,47,308,254,54,229,186,43,561,315,246,508,238,270,12.357,4.966,3.241
48127,Texas,Dimmit County,10822,31384,33.5,6561,400,261,2448,0,72,420,107,313,347,151,196,679,323,356,560,361,199,10.075,2.941,2.941
48479,Texas,Webb County,269624,40442,28.4,147331,18078,7589,45601,1765,3765,14759,6914,7845,14489,6634,7855,15474,8195,7279,16188,8630,7558,17.421,12.127,8.256
48157,Texas,Fort Bend County,711421,93645,35.8,453117,129438,77697,173534,5075,11262,29898,22545,7353,28074,21973,6101,37342,28236,9106,41346,33954,7392,45.713,9.414,6.49
48011,Texas,Armstrong County,1929,68750,45.9,1400,237,93,569,0,33,62,52,10,39,39,0,76,64,12,71,64,7,23.571,5.8,5.8
48069,Texas,Castro County,7891,44643,34.4,4738,414,220,1584,4,29,272,128,144,354,171,183,402,203,199,406,243,163,13.381,2.083,1.831
48235,Texas,Irion County,1592,63021,45.5,1051,95,61,514,0,45,93,61,32,59,37,22,50,32,18,40,21,19,14.843,8.755,8.755
48273,Texas,Kleberg County,31540,41700,27.9,17405,2897,1299,5808,68,247,3004,1988,1016,2955,2066,889,2005,1673,332,1604,1138,466,24.108,5.424,4.253
48489,Texas,Willacy County,21839,29104,33.4,13593,930,300,4465,122,221,1430,513,917,1043,532,511,1326,635,691,1015,631,384,9.049,7.682,4.95
48097,Texas,Cooke County,39064,60027,40.5,26188,4098,1847,10456,366,317,1743,1295,448,1727,1211,516,2128,1463,665,2046,1501,545,22.701,6.532,3.032
48107,Texas,Crosby County,5895,38674,37.7,3723,387,96,1415,24,38,256,117,139,249,151,98,279,206,73,278,119,159,12.973,4.382,2.686
48115,Texas,Dawson County,13095,43201,33.1,8404,771,298,3085,38,175,382,269,113,465,282,183,749,572,177,651,422,229,12.72,6.904,5.673
48151,Texas,Fisher County,3875,45294,44,2743,368,125,1227,2,19,140,114,26,126,76,50,200,139,61,186,99,87,17.973,1.711,1.548
48131,Texas,Duval County,11434,35443,36.8,7395,394,247,2584,2,7,573,245,328,465,136,329,642,358,284,568,323,245,8.668,0.348,0.271
48051,Texas,Burleson County,17596,52510,42.9,12293,1129,688,5126,36,168,652,454,198,682,463,219,846,607,239,865,571,294,14.781,3.98,3.277
48031,Texas,Blanco County,11089,58500,49.5,8208,1453,884,3240,33,257,425,309,116,375,154,221,363,279,84,259,181,78,28.472,8.951,7.932
48241,Texas,Jasper County,35444,41960,40.4,23929,1653,1130,8997,152,258,1460,1114,346,1399,892,507,1608,711,897,1757,1252,505,11.63,4.557,2.868
48245,Texas,Jefferson County,254574,46315,36,168757,21920,9941,58181,1453,2825,12679,8235,4444,12357,7840,4517,15310,9000,6310,14339,9283,5056,18.88,7.353,4.856
48271,Texas,Kinney County,3631,34926,41.1,2662,237,68,928,20,29,131,38,93,49,32,17,239,200,39,167,158,9,11.458,5.28,3.125
48359,Texas,Oldham County,2083,62426,29.9,1159,227,80,429,11,15,33,7,26,65,41,24,70,63,7,98,91,7,26.488,6.061,3.497
48117,Texas,Deaf Smith County,18947,51543,31.8,11084,1186,387,3978,34,105,886,471,415,886,686,200,1034,650,384,997,661,336,14.192,3.494,2.64
48167,Texas,Galveston County,321184,65702,37.6,214058,41264,21827,77873,1876,4416,13934,10293,3641,13433,10158,3275,17808,12541,5267,19018,14715,4303,29.474,8.08,5.671
48141,Texas,El Paso County,834825,43244,31.9,503599,76291,35258,162108,6019,11379,45047,25841,19206,43521,27503,16018,47466,28614,18852,52185,34607,17578,22.15,10.732,7.019
48283,Texas,La Salle County,7418,44601,33.9,5094,548,222,1607,15,108,556,272,284,280,239,41,459,207,252,391,128,263,15.116,7.654,6.721
48393,Texas,Roberts County,889,79167,37.8,597,152,34,242,0,6,14,12,2,14,14,0,53,49,4,60,45,15,31.156,2.479,2.479
48443,Texas,Terrell County,721,26063,47.3,561,54,43,263,0,8,10,0,10,0,0,0,25,25,0,59,53,6,17.291,3.042,3.042
48457,Texas,Tyler County,21456,44396,43,15046,1472,348,6163,153,227,755,300,455,579,362,217,528,404,124,854,697,157,12.096,6.166,3.683
48463,Texas,Uvalde County,27015,40781,33.8,16679,1823,698,6284,160,220,1486,761,725,1230,865,365,1457,1010,447,1659,1074,585,15.115,6.047,3.501
48483,Texas,Wheeler County,5599,50910,39.4,3748,429,119,1461,10,36,210,120,90,209,151,58,319,254,65,306,210,96,14.621,3.149,2.464
48037,Texas,Bowie County,93635,46283,38.2,63181,8340,3819,21583,351,791,3859,2809,1050,3656,2868,788,4617,3062,1555,4969,3490,1479,19.245,5.291,3.665
48009,Texas,Archer County,8793,63192,44.8,6171,1122,333,2752,51,144,380,298,82,220,197,23,384,316,68,425,322,103,23.578,7.086,5.233
48043,Texas,Brewster County,9220,38906,43.1,6737,1492,915,2155,20,154,392,248,144,503,313,190,502,382,120,418,346,72,35.728,8.074,7.146
48263,Texas,Kent County,680,52250,46.7,496,86,32,202,2,0,26,26,0,0,0,0,25,14,11,40,32,8,23.79,0.99,0
48215,Texas,Hidalgo County,839539,37097,28.9,465095,59522,23471,156949,4934,10115,43887,18821,25066,45278,20510,24768,47342,23117,24225,49125,24239,24886,17.844,9.588,6.445
48423,Texas,Smith County,222277,50742,36.6,144635,25104,11297,51275,1470,2530,10908,6786,4122,11175,7947,3228,12339,8700,3639,13902,10353,3549,25.167,7.801,4.934
48425,Texas,Somervell County,8650,52346,40.6,5975,822,375,2391,162,194,300,249,51,330,207,123,518,460,58,485,385,100,20.033,14.889,8.114
48105,Texas,Crockett County,3836,52310,35.5,2460,166,53,1027,0,0,208,96,112,197,116,81,229,160,69,233,170,63,8.902,0,0
49027,Utah,Millard County,12651,59312,35.5,7663,1241,401,3328,48,101,484,429,55,446,327,119,584,372,212,598,424,174,21.428,4.477,3.035
49045,Utah,Tooele County,63357,66542,31.1,36102,5980,2173,15499,681,720,2692,2333,359,2602,2355,247,3445,3010,435,3828,3483,345,22.583,9.039,4.645
49053,Utah,Washington County,155577,55175,35.9,98391,17275,10384,36722,1453,2773,6550,4571,1979,6789,5196,1593,8160,6032,2128,8529,6569,1960,28.111,11.508,7.551
49025,Utah,Kane County,7246,50266,42.2,5029,846,512,2036,108,116,108,58,50,287,221,66,385,265,120,298,271,27,27.003,11.002,5.697
49043,Utah,Summit County,39731,94952,38.8,26377,8638,5482,10899,369,949,1602,1348,254,1503,1277,226,2216,1703,513,1984,1600,384,53.531,12.093,8.707
49019,Utah,Grand County,9544,46658,39.8,6556,1136,686,2710,51,96,414,228,186,409,323,86,510,322,188,430,206,224,27.791,5.424,3.542
49031,Utah,Piute County,1860,41750,40.6,1359,252,56,455,18,1,10,5,5,77,75,2,110,62,48,119,110,9,22.664,4.176,0.22
49033,Utah,Rich County,2307,52917,34.3,1392,251,66,461,6,20,107,59,48,53,46,7,60,54,6,173,54,119,22.773,5.64,4.338
49051,Utah,Wasatch County,29306,74552,33.3,17356,4524,2189,6309,263,496,1387,1214,173,1064,887,177,1392,1251,141,1627,1385,242,38.678,12.03,7.862
49001,Utah,Beaver County,6414,47878,33.3,3800,486,216,1643,47,64,182,153,29,301,192,109,331,230,101,286,219,67,18.474,6.756,3.895
49003,Utah,Box Elder County,52182,58835,32.3,30559,4902,2028,12987,397,721,2408,2095,313,2054,1752,302,2807,2390,417,2868,2411,457,22.677,8.609,5.552
49021,Utah,Iron County,48504,45422,29.1,26912,5330,2399,10023,357,646,3572,2529,1043,3504,2803,701,2871,2098,773,2783,2185,598,28.72,10.007,6.445
49039,Utah,Sanpete County,28892,50928,31.7,16713,2109,1096,6193,179,280,1624,1270,354,1909,1657,252,1117,841,276,1365,1003,362,19.177,7.412,4.521
49041,Utah,Sevier County,20961,50850,34.9,12873,1429,735,5503,210,245,799,527,272,717,536,181,1069,872,197,1137,923,214,16.81,8.268,4.452
49049,Utah,Utah County,576496,67042,24.5,280797,76063,34462,104703,3763,5725,46237,41417,4820,45641,41224,4417,36424,30037,6387,35966,30973,4993,39.361,9.062,5.468
49057,Utah,Weber County,244101,62036,32.3,149578,24534,11290,58406,2253,2830,12066,10220,1846,11936,9863,2073,16294,13095,3199,16242,13724,2518,23.95,8.703,4.845
49013,Utah,Duchesne County,20259,63000,30.3,11586,1203,480,4941,142,238,763,549,214,856,639,217,1285,1028,257,1220,967,253,14.526,7.691,4.817
49037,Utah,San Juan County,15193,42581,31.6,8813,972,554,3235,32,94,762,426,336,685,446,239,746,407,339,736,457,279,17.315,3.895,2.906
49035,Utah,Salt Lake County,1106700,67922,32.4,689802,147726,84173,241328,8681,14981,54521,43923,10598,54500,46530,7970,83411,66951,16460,81113,68021,13092,33.618,9.805,6.208
49047,Utah,Uintah County,36343,67012,30.1,20749,2165,801,8104,394,319,1753,1442,311,1560,1126,434,2470,1698,772,2473,2014,459,14.295,8.798,3.936
49009,Utah,Daggett County,702,85000,47.3,494,35,11,157,3,7,9,9,0,22,22,0,0,0,0,6,6,0,9.312,6.369,4.459
49011,Utah,Davis County,334977,75961,30.6,193263,47983,22034,78443,2601,3557,14424,12416,2008,14276,12846,1430,21411,18455,2956,22323,19586,2737,36.229,7.85,4.535
49055,Utah,Wayne County,2700,42444,40.4,1795,330,137,758,29,41,90,39,51,43,32,11,124,92,32,132,78,54,26.017,9.235,5.409
49007,Utah,Carbon County,20512,46994,36.4,13094,1440,612,5712,173,377,999,760,239,869,701,168,1080,728,352,1223,954,269,15.671,9.629,6.6
49015,Utah,Emery County,10410,51852,35,6356,741,215,2848,59,88,361,277,84,334,245,89,489,393,96,588,501,87,15.041,5.162,3.09
49029,Utah,Morgan County,11014,86071,32.4,6208,1593,891,2736,56,200,439,433,6,383,321,62,510,465,45,578,490,88,40.013,9.357,7.31
49005,Utah,Cache County,120288,53812,25,60112,14861,7306,23228,937,1178,11141,9717,1424,11135,10081,1054,7468,6166,1302,6938,5933,1005,36.876,9.105,5.071
49017,Utah,Garfield County,5020,51700,41.2,3375,534,178,1405,35,92,181,81,100,166,99,67,213,175,38,222,178,44,21.096,9.039,6.548
49023,Utah,Juab County,10694,57590,30.7,5986,718,287,2657,99,168,499,327,172,432,397,35,477,377,100,564,432,132,16.789,10.049,6.323
50021,Vermont,Rutland County,59676,52635,46.4,43156,8137,4796,18141,752,1440,2875,2607,268,2680,2424,256,2713,2320,393,2682,2431,251,29.968,12.083,7.938
50019,Vermont,Orleans County,26951,45664,45.4,19590,2687,1624,8948,285,853,937,832,105,963,916,47,1239,975,264,1184,1098,86,22.006,12.718,9.533
50013,Vermont,Grand Isle County,6950,66111,48.1,5218,1202,798,2362,87,259,270,259,11,213,204,9,305,261,44,356,327,29,38.329,14.649,10.965
50017,Vermont,Orange County,28901,56584,45.7,20990,3702,2597,9911,428,876,1265,1143,122,1027,894,133,1355,1080,275,1429,1356,73,30.01,13.157,8.839
50007,Vermont,Chittenden County,160985,66906,36.6,105259,30524,21722,40980,1839,2964,12174,11438,736,12325,11745,580,9876,8952,924,9805,9246,559,49.636,11.72,7.233
50015,Vermont,Lamoille County,25191,54899,40.5,17428,4006,2542,7427,290,711,1149,1033,116,1077,968,109,1451,1222,229,1451,1235,216,37.572,13.478,9.573
50027,Vermont,Windsor County,55485,56828,47.4,41605,8535,6443,17304,889,1360,1762,1403,359,1635,1523,112,2591,2133,458,2911,2630,281,36,12.997,7.859
50011,Vermont,Franklin County,48816,62214,39.9,33856,5594,2776,13848,493,1119,1942,1829,113,1676,1552,124,2652,2366,286,2857,2702,155,24.722,11.641,8.081
50005,Vermont,Caledonia County,30576,47371,43.7,21537,3602,2402,8850,344,670,1407,1265,142,1221,1142,79,1435,1131,304,1420,1366,54,27.878,11.458,7.571
50025,Vermont,Windham County,43332,50831,46.8,31839,6812,4960,12906,525,1216,1839,1648,191,1635,1536,99,2155,1816,339,2065,1858,207,36.974,13.49,9.422
50003,Vermont,Bennington County,36054,52251,46.6,25675,5409,3393,11139,601,862,1649,1457,192,1612,1443,169,1495,1237,258,1565,1398,167,34.282,13.134,7.739
50001,Vermont,Addison County,36825,61875,43.4,25207,5487,3766,10648,504,963,2368,2143,225,2201,2034,167,1572,1293,279,1763,1668,95,36.708,13.777,9.044
50009,Vermont,Essex County,6203,38767,50,4707,427,263,2148,87,163,212,167,45,190,179,11,219,166,53,236,203,33,14.659,11.639,7.588
50023,Vermont,Washington County,58691,60602,43.5,41833,9466,7470,17709,682,1290,2883,2754,129,2106,2020,86,2902,2511,391,3008,2836,172,40.485,11.136,7.284
51036,Virginia,Charles City County,7022,55069,49.8,5418,432,259,2415,124,173,243,162,81,232,210,22,298,225,73,327,243,84,12.754,12.298,7.164
51047,Virginia,Culpeper County,49795,69693,38.8,33245,4869,2925,12272,544,867,1593,1380,213,1811,1564,247,2414,1808,606,2654,2114,540,23.444,11.498,7.065
51053,Virginia,Dinwiddie County,28033,54640,42.9,19760,2071,1202,7982,187,560,1168,884,284,1259,1065,194,1351,1067,284,1434,1377,57,16.564,9.359,7.016
51079,Virginia,Greene County,19213,62952,39.6,13254,2023,1513,5852,294,511,578,382,196,706,607,99,1128,935,193,1136,872,264,26.679,13.756,8.732
51085,Virginia,Hanover County,103218,84955,42.6,70574,17767,8999,31070,1049,1641,4588,4102,486,4207,3856,351,4177,3514,663,4468,4088,380,37.926,8.658,5.282
51111,Virginia,Lunenburg County,12369,39537,45.4,9058,704,252,3227,134,165,495,222,273,406,279,127,490,386,104,520,504,16,10.554,9.266,5.113
51137,Virginia,Orange County,35265,67196,41.9,24766,3861,2476,10406,441,668,1385,1053,332,1285,956,329,1538,1119,419,1638,1334,304,25.587,10.657,6.419
51595,Virginia,Emporia city,5495,27426,35.9,3660,368,192,902,25,137,221,153,68,226,185,41,392,210,182,350,239,111,15.301,17.96,15.188
51197,Virginia,Wythe County,29048,46119,44.4,21161,2377,1485,9036,128,602,1127,890,237,958,738,220,1262,1124,138,1505,1075,430,18.251,8.079,6.662
51550,Virginia,Chesapeake city,235410,72214,36.6,156680,30660,18686,58843,2773,5288,9817,7795,2022,9604,8047,1557,11374,9139,2235,14573,12234,2339,31.495,13.699,8.987
51570,Virginia,Colonial Heights city,17582,50952,40.1,12292,1863,1032,4471,219,316,570,404,166,711,610,101,1037,760,277,1191,887,304,23.552,11.966,7.068
51660,Virginia,Harrisonburg city,53064,43009,24.8,26410,5427,3803,6445,227,351,6957,6372,585,8660,7897,763,3290,2163,1127,3231,2025,1206,34.949,8.968,5.446
51003,Virginia,Albemarle County,105105,72265,38.6,70813,18931,18100,25459,854,1387,5528,5055,473,5762,5223,539,5733,4890,843,5986,5324,662,52.294,8.802,5.448
51021,Virginia,Bland County,6524,46927,45.3,5016,550,162,2116,36,29,214,200,14,198,163,35,280,271,9,204,151,53,14.195,3.072,1.371
51019,Virginia,Bedford County,77319,59405,45.9,55513,9826,5861,25167,670,1197,2805,2311,494,2989,2446,543,3138,2581,557,3114,2647,467,28.258,7.418,4.756
51023,Virginia,Botetourt County,33149,64733,47.2,24133,4467,2364,11274,344,767,1186,982,204,1076,963,113,1393,1218,175,1289,1220,69,28.306,9.855,6.803
51029,Virginia,Buckingham County,17048,46610,42.7,12473,939,479,4298,132,264,588,376,212,521,406,115,875,624,251,775,704,71,11.369,9.214,6.142
51195,Virginia,Wise County,39539,38255,40.3,27735,2394,1471,10455,136,437,1912,1412,500,1659,1344,315,2115,1627,488,1878,1559,319,13.935,5.481,4.18
51520,Virginia,Bristol city,17077,37844,42.3,12225,1842,975,4372,44,215,608,392,216,694,598,96,951,673,278,927,769,158,23.043,5.924,4.918
51580,Virginia,Covington city,5675,35546,44.2,3923,343,228,1805,6,82,311,221,90,262,205,57,154,87,67,164,126,38,14.555,4.875,4.543
51740,Virginia,Portsmouth city,95536,48727,35.2,63497,9067,4810,19936,934,2328,4243,3172,1071,4601,3559,1042,5713,3938,1775,6540,5468,1072,21.855,16.362,11.677
51830,Virginia,Williamsburg city,14817,54606,24.5,7270,2022,1990,2198,92,215,2321,2230,91,2950,2883,67,701,636,65,653,582,71,55.186,13.967,9.782
51810,Virginia,Virginia Beach city,450057,70500,35.6,303492,68828,36870,107096,5817,9935,18429,14842,3587,20483,17180,3303,27073,20881,6192,31596,27061,4535,34.827,14.708,9.277
51005,Virginia,Alleghany County,15489,46020,46.9,11385,1192,607,5225,85,253,604,472,132,458,329,129,676,471,205,732,651,81,15.801,6.469,4.842
51035,Virginia,Carroll County,29767,41145,47,21908,2310,868,9760,309,631,1196,955,241,888,646,242,1281,872,409,1304,1063,241,14.506,9.631,6.465
51640,Virginia,Galax city,6788,31311,46.6,5033,286,233,1674,59,42,136,136,0,239,191,48,303,191,112,230,230,0,10.312,6.033,2.509
51191,Virginia,Washington County,54457,44844,45.5,39882,5780,3567,16926,504,742,2023,1623,400,2001,1484,517,2483,1902,581,2423,2031,392,23.437,7.361,4.384
51193,Virginia,Westmoreland County,17596,55688,47.6,13023,1776,978,5695,184,468,692,514,178,565,355,210,760,436,324,905,773,132,21.147,11.449,8.218
51133,Virginia,Northumberland County,12254,56677,56.5,9774,1537,1039,4917,158,397,328,295,33,308,219,89,528,325,203,401,356,45,26.356,11.287,8.074
51139,Virginia,Page County,23694,46140,45,17201,1498,768,6525,426,294,843,639,204,780,603,177,1056,847,209,1141,878,263,13.174,11.034,4.506
51155,Virginia,Pulaski County,34330,49691,46.2,25536,3088,1632,10615,219,497,1424,1079,345,1184,946,238,1357,1174,183,1530,1220,310,18.484,6.745,4.682
51187,Virginia,Warren County,38991,65353,40.6,26801,3745,1847,10887,354,881,1832,1578,254,1465,1177,288,2090,1540,550,2214,1728,486,20.865,11.344,8.092
51510,Virginia,Alexandria city,154710,93370,36.4,117664,34403,38353,29576,937,1856,4913,3513,1400,5864,4472,1392,14644,11669,2975,17018,14513,2505,61.834,9.443,6.275
51590,Virginia,Danville city,41911,34951,40.6,28890,3438,2015,9844,311,667,1714,1277,437,1949,1420,529,2200,1666,534,2321,1917,404,18.875,9.935,6.776
51630,Virginia,Fredericksburg city,28135,57258,29.9,16734,4053,3131,3746,134,275,1959,1755,204,3475,3129,346,1945,1619,326,1699,1362,337,42.931,10.918,7.341
51650,Virginia,Hampton city,136255,52021,35.8,90596,14215,8984,30471,1645,3149,6952,5470,1482,7258,6162,1096,7976,5804,2172,9442,8155,1287,25.607,15.733,10.334
51009,Virginia,Amherst County,31819,49677,43.9,22453,2879,1600,9313,215,464,1411,1003,408,1557,1351,206,1320,1026,294,1394,1214,180,19.948,7.291,4.982
51013,Virginia,Arlington County,229534,112138,34.4,171870,59644,67769,45525,1230,2626,10559,9139,1420,11537,10412,1125,25941,23140,2801,26288,24063,2225,74.133,8.47,5.768
51017,Virginia,Bath County,4458,44483,47.3,3259,374,144,1365,122,64,66,21,45,212,158,54,205,143,62,230,171,59,15.894,13.626,4.689
51670,Virginia,Hopewell city,22353,40712,36.5,14772,1564,668,4653,200,201,904,786,118,985,782,203,1257,821,436,1549,1308,241,15.11,8.618,4.32
51027,Virginia,Buchanan County,22611,30828,46.3,16961,1132,696,7116,50,423,894,648,246,784,645,139,1098,688,410,1008,819,189,10.778,6.647,5.944
51700,Virginia,Newport News city,180775,51082,33.2,115972,17727,11044,34345,1358,2424,8420,6608,1812,10280,8570,1710,11427,8421,3006,13419,10962,2457,24.809,11.012,7.058
51069,Virginia,Frederick County,83784,71037,40.5,57528,9691,6268,23620,853,1288,3322,2339,983,3023,2380,643,4057,3047,1010,4524,3756,768,27.741,9.064,5.453
51179,Virginia,Stafford County,141159,103005,35.2,89555,20410,14221,34377,1309,1866,5757,4779,978,6100,5625,475,7241,5578,1663,7719,6802,917,38.67,9.236,5.428
51680,Virginia,Lynchburg city,79237,41971,28.3,43955,8837,5915,13978,513,857,8669,7613,1056,9664,8627,1037,4356,3556,800,4568,3979,589,33.562,9.801,6.131
51199,Virginia,York County,67196,86781,39.6,44827,10415,9148,17547,614,930,2416,2144,272,2751,2515,236,2555,2127,428,3081,2867,214,43.641,8.799,5.3
51760,Virginia,Richmond city,220892,42356,33.5,151030,33703,22874,37190,1624,3664,15020,11667,3353,16425,13538,2887,18531,13922,4609,20060,16221,3839,37.461,14.219,9.852
51690,Virginia,Martinsville city,13256,33545,41.5,9137,1193,714,3165,120,205,477,265,212,561,365,196,507,334,173,738,494,244,20.871,10.269,6.477
51125,Virginia,Nelson County,14863,53834,49.7,11068,1752,1654,4685,242,441,397,273,124,501,419,82,749,473,276,588,444,144,30.773,14.578,9.413
51057,Virginia,Essex County,11083,50629,44.8,7760,1001,462,3153,167,289,436,384,52,550,415,135,395,329,66,448,377,71,18.853,14.462,9.166
51143,Virginia,Pittsylvania County,61970,44356,46.4,45237,4273,2120,20068,589,1195,2058,1379,679,2094,1808,286,2747,1989,758,2695,2020,675,14.132,8.89,5.955
51720,Virginia,Norton city,4043,26971,37.2,2878,368,120,868,14,62,89,61,28,222,180,42,172,107,65,340,269,71,16.956,8.756,7.143
51790,Virginia,Staunton city,24273,46435,42,17297,3268,2573,6026,185,334,856,673,183,1509,1293,216,1278,1017,261,1557,1323,234,33.769,8.613,5.543
51065,Virginia,Fluvanna County,26109,67964,42.6,18515,3411,2567,7911,202,761,916,718,198,980,637,343,1048,796,252,1125,1051,74,32.287,12.173,9.62
51007,Virginia,Amelia County,12802,58535,46.5,8962,911,388,3928,99,303,460,399,61,493,408,85,602,442,160,382,360,22,14.495,10.234,7.714
51750,Virginia,Radford city,17380,36082,22.7,7612,1410,1210,2559,42,63,3421,3067,354,3408,3191,217,772,511,261,701,593,108,34.419,4.103,2.462
51840,Virginia,Winchester city,27516,49330,37.6,18224,3364,2560,4802,181,300,1540,1168,372,1532,1133,399,1361,940,421,1600,1184,416,32.507,10.017,6.247
51001,Virginia,Accomack County,32840,42260,46,23558,2688,1921,9466,260,507,1184,765,419,1355,851,504,1486,835,651,1463,1077,386,19.564,8.103,5.356
51045,Virginia,Craig County,5131,53526,47.5,3851,548,190,1734,0,19,167,136,31,173,157,16,253,208,45,228,228,0,19.164,1.096,1.096
51063,Virginia,Floyd County,15594,48396,46,11463,1388,838,5196,121,209,406,306,100,567,481,86,764,509,255,690,557,133,19.419,6.351,4.022
51071,Virginia,Giles County,16867,49734,44.4,12168,1219,853,5300,103,200,692,478,214,667,523,144,797,541,256,785,667,118,17.028,5.717,3.774
51077,Virginia,Grayson County,15708,32048,47.4,11847,1139,378,5238,98,266,474,335,139,535,377,158,708,589,119,682,493,189,12.805,6.949,5.078
51135,Virginia,Nottoway County,15537,38410,41.3,10985,965,536,3318,78,210,818,574,244,486,397,89,810,646,164,681,632,49,13.664,8.68,6.329
51157,Virginia,Rappahannock County,7359,62541,49.5,5530,1084,776,2354,104,177,226,181,45,221,215,6,349,204,145,314,225,89,33.635,11.937,7.519
51185,Virginia,Tazewell County,42689,40309,44.3,30927,2940,1774,13304,369,517,1786,1207,579,1489,1153,336,1895,1364,531,2026,1434,592,15.242,6.66,3.886
51530,Virginia,Buena Vista city,6495,33672,36.4,4068,352,313,1623,25,188,569,369,200,438,352,86,245,212,33,347,268,79,16.347,13.124,11.583
51610,Virginia,Falls Church city,13843,114795,39.7,9471,3371,4029,3178,150,199,438,417,21,583,532,51,742,674,68,747,716,31,78.133,10.982,6.262
51685,Virginia,Manassas Park city,16117,79131,34.1,10529,2284,1021,3224,242,338,881,539,342,553,347,206,1139,775,364,1096,747,349,31.389,17.99,10.484
51730,Virginia,Petersburg city,32037,33939,38.3,22212,2254,1629,5532,302,582,1506,1160,346,1660,1275,385,1786,1282,504,2325,1933,392,17.482,15.98,10.521
51735,Virginia,Poquoson city,12022,88328,42.2,8297,2009,1435,3659,163,183,491,442,49,507,443,64,477,468,9,437,402,35,41.509,9.456,5.001
51183,Virginia,Sussex County,11595,44608,40.4,8948,660,389,2395,35,160,196,184,12,185,166,19,147,131,16,296,273,23,11.723,8.142,6.681
51600,Virginia,Fairfax city,23580,106870,39,16279,4797,4460,5949,214,478,1340,1200,140,1139,1024,115,1444,1069,375,1252,1044,208,56.865,11.632,8.035
51820,Virginia,Waynesboro city,21620,42112,40,14905,1967,1356,5376,168,450,749,322,427,968,699,269,1263,983,280,1185,1042,143,22.295,11.496,8.371
51683,Virginia,Manassas city,41379,77551,33.5,26439,4683,3175,7979,374,682,2022,1401,621,1913,1475,438,3099,2308,791,2837,2061,776,29.721,13.235,8.547
51770,Virginia,Roanoke city,99572,41483,38.4,69498,9955,6167,21977,1114,1752,4228,2596,1632,4361,3416,945,6583,5015,1568,7006,5865,1141,23.198,13.041,7.972
51775,Virginia,Salem city,25521,53990,41.1,17175,2995,1769,6551,222,274,1341,1254,87,1640,1396,244,1329,1099,230,1294,1132,162,27.738,7.571,4.183
51800,Virginia,Suffolk city,88057,68089,38.1,58966,9585,6482,22380,1102,2200,3481,2829,652,3518,2987,531,4402,3464,938,5303,4666,637,27.248,14.754,9.83
51710,Virginia,Norfolk city,245752,47137,30.4,151651,25001,16388,37854,2159,4369,17062,13960,3102,15165,12728,2437,16100,11813,4287,17102,14295,2807,27.292,17.245,11.542
51037,Virginia,Charlotte County,12176,38350,45.2,8478,665,342,3198,94,114,482,230,252,512,412,100,485,351,134,394,295,99,11.878,6.504,3.565
51041,Virginia,Chesterfield County,335594,76969,38.8,223906,53337,32532,91047,3251,5668,14009,11816,2193,14906,12965,1941,17099,13595,3504,17741,15068,2673,38.35,9.796,6.225
51059,Virginia,Fairfax County,1142004,117515,37.9,777179,240721,230706,266707,10575,18527,47298,39352,7946,45417,38168,7249,69443,56943,12500,69851,60305,9546,60.659,10.912,6.947
51081,Virginia,Greensville County,11606,42121,41.1,8706,389,262,2754,51,186,259,185,74,346,243,103,531,379,152,388,266,122,7.478,8.606,6.754
51093,Virginia,Isle of Wight County,36090,67767,44.4,25773,4162,2773,10939,442,675,1199,1028,171,1176,1001,175,1565,1318,247,1765,1468,297,26.908,10.211,6.171
51095,Virginia,James City County,73028,80772,45.9,52771,13799,11495,21117,631,1276,2429,1920,509,2519,2232,287,2965,2591,374,3287,2845,442,47.932,9.031,6.043
51167,Virginia,Russell County,27725,40083,44.8,20274,1899,853,8643,167,451,1055,729,326,1028,884,144,1347,869,478,1309,1038,271,13.574,7.15,5.218
51620,Virginia,Franklin city,8334,38760,38.7,5731,875,574,1726,91,189,320,204,116,337,214,123,386,254,132,599,525,74,25.284,16.222,10.95
51173,Virginia,Smyth County,31298,40544,44.6,22737,2027,1267,9015,238,303,1158,819,339,1339,1108,231,1573,1177,396,1412,1021,391,14.487,6.001,3.361
51540,Virginia,Charlottesville city,46487,54739,30.9,29754,7383,7923,8116,354,450,4794,4434,360,5155,4742,413,4217,3551,666,4450,3984,466,51.442,9.906,5.545
51678,Virginia,Lexington city,7113,37309,21.6,2611,542,462,1147,131,121,1353,1285,68,787,753,34,83,76,7,132,112,20,38.453,21.97,10.549
51031,Virginia,Campbell County,55158,48823,42.8,39366,5324,3147,16947,459,1007,2425,2067,358,2326,1866,460,3033,2481,552,3078,2803,275,21.519,8.65,5.942
51087,Virginia,Henrico County,324073,66447,38.3,222616,57871,35748,79311,3455,5764,13056,10502,2554,13716,11622,2094,19774,15949,3825,21381,18393,2988,42.054,11.624,7.268
51089,Virginia,Henry County,51956,36779,46.8,38003,3045,1807,16220,395,914,1780,1208,572,1978,1588,390,2312,1773,539,2311,1746,565,12.767,8.07,5.635
51099,Virginia,King George County,25564,84770,37.1,16792,3632,2109,6780,195,413,1106,891,215,1017,883,134,1282,957,325,1346,1185,161,34.189,8.968,6.091
51109,Virginia,Louisa County,34813,56946,44.5,25136,3537,2306,10721,332,779,1187,928,259,1186,899,287,1736,1311,425,1858,1543,315,23.246,10.363,7.266
51101,Virginia,King William County,16329,67423,41.3,11308,1554,590,5233,110,469,652,502,150,665,552,113,896,844,52,881,806,75,18.96,11.064,8.962
51103,Virginia,Lancaster County,10848,51495,56.3,8582,1325,1411,3719,100,284,277,174,103,296,181,115,336,260,76,315,291,24,31.881,10.325,7.636
51105,Virginia,Lee County,24428,32590,43.8,18167,1311,706,6671,183,198,840,667,173,784,571,213,1079,626,453,1075,855,220,11.103,5.711,2.968
51115,Virginia,Mathews County,8830,63622,52.6,6957,1199,674,3248,249,201,278,136,142,271,218,53,429,337,92,320,237,83,26.923,13.855,6.188
51119,Virginia,Middlesex County,10710,50483,53.5,8270,1117,711,3659,142,374,419,291,128,347,321,26,275,208,67,382,325,57,22.104,14.102,10.221
51147,Virginia,Prince Edward County,22903,44147,30.8,12726,1529,1643,4722,210,291,2793,2562,231,2638,2347,291,525,493,32,939,775,164,24.925,10.61,6.163
51149,Virginia,Prince George County,37704,68461,37.1,26218,3995,2047,7710,237,430,1268,910,358,1270,1119,151,2142,1723,419,1918,1698,220,23.045,8.651,5.577
51159,Virginia,Richmond County,8873,47341,44,6773,640,269,2338,58,162,226,174,52,281,214,67,257,251,6,201,183,18,13.421,9.41,6.929
51165,Virginia,Rockingham County,78653,57651,41.8,53694,7865,5448,22351,719,1032,3475,2836,639,3650,2951,699,3663,2907,756,3789,3092,697,24.794,7.834,4.617
51169,Virginia,Scott County,22290,38725,46.3,16561,1513,684,6931,126,225,978,640,338,753,591,162,870,689,181,887,744,143,13.266,5.064,3.246
51177,Virginia,Spotsylvania County,130159,81434,37.7,85662,16280,9804,33482,1194,2406,5390,4590,800,5350,4772,578,7146,5287,1859,7428,6266,1162,30.45,10.752,7.186
51181,Virginia,Surry County,6670,54656,49.3,4986,643,310,2110,100,94,219,156,63,302,220,82,326,202,124,242,181,61,19.114,9.194,4.455
51011,Virginia,Appomattox County,15462,54875,43.5,11014,1285,987,4817,169,236,495,409,86,525,450,75,837,732,105,809,702,107,20.628,8.408,4.899
51043,Virginia,Clarke County,14331,72129,46,10243,1589,1637,4176,110,444,745,557,188,476,303,173,449,378,71,567,426,141,31.495,13.266,10.632
51067,Virginia,Franklin County,56277,51208,46,40619,5050,3338,18393,533,1361,1966,1330,636,2301,1705,596,2610,2026,584,2653,2053,600,20.65,10.297,7.4
51097,Virginia,King and Queen County,7052,51495,45.1,5179,583,394,2213,29,182,319,212,107,273,220,53,293,252,41,239,220,19,18.865,9.535,8.224
51117,Virginia,Mecklenburg County,30959,41126,47.9,22775,2727,1428,8503,314,537,1115,677,438,1069,885,184,1226,922,304,1346,1007,339,18.244,10.008,6.315
51121,Virginia,Montgomery County,97692,53424,28.2,54875,12139,13253,19520,763,671,14385,13319,1066,10711,10292,419,5886,5081,805,5546,4714,832,46.272,7.346,3.438
51127,Virginia,New Kent County,20523,78429,44,14758,2467,1496,6182,75,536,663,610,53,793,704,89,974,868,106,956,865,91,26.853,9.884,8.67
51015,Virginia,Augusta County,74390,59544,44.6,53897,8020,4610,22774,794,1345,2612,2063,549,2485,2022,463,3337,2494,843,3339,2640,699,23.434,9.392,5.906
51049,Virginia,Cumberland County,9797,43020,44.5,6945,687,471,2870,119,332,373,304,69,460,329,131,456,268,188,392,304,88,16.674,15.714,11.568
51051,Virginia,Dickenson County,15181,29916,43.9,11058,626,407,4630,106,346,590,418,172,549,421,128,668,412,256,651,566,85,9.342,9.762,7.473
51075,Virginia,Goochland County,22148,86652,48.4,16566,4080,2358,7186,204,490,619,607,12,734,611,123,791,649,142,696,628,68,38.863,9.658,6.819
51083,Virginia,Halifax County,35030,39233,45.9,25050,2529,1466,10220,360,643,1349,982,367,1305,967,338,1337,1018,319,1635,1474,161,15.948,9.814,6.292
51107,Virginia,Loudoun County,374558,129588,35.8,239466,84709,58497,94437,3827,6005,12692,11033,1659,12320,10852,1468,20355,17233,3122,22608,20425,2183,59.802,10.411,6.359
51113,Virginia,Madison County,13108,52287,45.2,9346,1549,965,3749,177,344,581,404,177,541,499,42,654,499,155,597,451,146,26.899,13.897,9.176
51153,Virginia,Prince William County,450763,101059,34.7,286605,68227,45897,100948,3843,8123,19051,14651,4400,19101,15238,3863,26505,19745,6760,28189,23694,4495,39.819,11.854,8.047
51161,Virginia,Roanoke County,93419,62134,43.7,66837,15458,7741,28751,745,1421,3413,2801,612,3713,3346,367,4230,3619,611,4343,3885,458,34.71,7.534,4.942
51175,Virginia,Southampton County,18089,53681,45.8,13198,1648,866,4773,144,257,657,528,129,543,484,59,726,526,200,772,666,106,19.048,8.401,5.384
51091,Virginia,Highland County,2213,45094,60.5,1870,275,193,994,13,54,33,25,8,43,39,4,31,2,29,90,36,54,25.027,6.74,5.433
51025,Virginia,Brunswick County,16435,40871,43.4,11899,935,618,4472,121,300,796,658,138,553,500,53,545,357,188,627,592,35,13.052,9.414,6.708
51033,Virginia,Caroline County,29889,60925,40.2,20402,2748,1159,8668,393,570,521,414,107,968,944,24,1045,842,203,1760,1488,272,19.15,11.11,6.576
51073,Virginia,Gloucester County,37035,63881,44.6,26799,3842,2272,11378,392,861,1541,1210,331,1379,1047,332,1767,1513,254,1857,1700,157,22.814,11.012,7.567
51131,Virginia,Northampton County,11998,41468,48.4,8742,1252,779,3344,92,164,382,275,107,449,414,35,509,279,230,486,324,162,23.233,7.656,4.904
51141,Virginia,Patrick County,17958,37757,49.2,13528,1223,709,5942,135,326,626,459,167,587,514,73,633,423,210,721,424,297,14.281,7.758,5.486
51145,Virginia,Powhatan County,28364,80441,44.6,20692,4242,1640,8954,258,897,845,660,185,913,750,163,1028,901,127,1032,954,78,28.426,12.899,10.018
51163,Virginia,Rockbridge County,22440,53918,48.6,16876,2535,1817,7040,291,503,718,469,249,771,606,165,1061,801,260,958,820,138,25.788,11.278,7.145
51171,Virginia,Shenandoah County,42854,53934,44.2,30585,3940,1927,12035,292,569,1681,1357,324,1515,1163,352,1994,1528,466,2182,1709,473,19.183,7.154,4.728
51061,Virginia,Fauquier County,68406,94775,41.6,46770,10212,6300,18803,686,1338,2574,2220,354,2555,2227,328,3213,2354,859,3073,2595,478,35.305,10.764,7.116
53047,Washington,Okanogan County,41377,42598,43.1,28734,3338,1927,11502,250,793,1409,783,626,1365,1010,355,1979,1217,762,1949,1356,593,18.323,9.068,6.894
53037,Washington,Kittitas County,43726,53163,33.3,26293,6134,3073,10172,308,879,4665,3787,878,4383,3879,504,2208,1803,405,2078,1820,258,35.017,11.669,8.641
53067,Washington,Thurston County,269885,66113,38.9,187617,40434,24187,67862,2719,4618,11688,10075,1613,11534,9932,1602,15266,12715,2551,16950,15317,1633,34.443,10.812,6.805
53005,Washington,Benton County,190529,63001,35.6,122845,22888,13946,47936,1387,2587,8341,6599,1742,8067,6405,1662,11724,8864,2860,11197,9530,1667,29.984,8.29,5.397
53013,Washington,Columbia County,3999,46250,50,3043,545,260,1249,66,81,126,97,29,77,71,6,122,114,8,207,171,36,26.454,11.769,6.485
53011,Washington,Clark County,457474,67832,38,305853,58319,30512,110347,4877,7925,18819,15557,3262,18337,16066,2271,25756,20849,4907,26400,22972,3428,29.044,11.602,7.182
53003,Washington,Asotin County,22259,47483,44.7,15893,2429,973,6531,161,336,769,639,130,1163,987,176,1048,753,295,987,875,112,21.406,7.61,5.145
53001,Washington,Adams County,19261,48131,28.4,10569,946,490,3745,65,233,1040,524,516,942,587,355,1019,595,424,1031,777,254,13.587,7.957,6.222
53023,Washington,Garfield County,2226,51399,46.7,1638,270,107,695,0,21,16,9,7,48,48,0,88,88,0,129,87,42,23.016,3.022,3.022
53045,Washington,Mason County,61569,53087,45.9,45104,5599,2446,17785,970,1403,2519,1833,686,1967,1612,355,3207,2414,793,2631,2131,500,17.837,13.343,7.889
53057,Washington,Skagit County,121725,59263,41.4,84567,13821,7849,32080,1460,2639,4910,3690,1220,4673,3838,835,6736,5122,1614,6624,5501,1123,25.625,12.777,8.226
53065,Washington,Stevens County,43858,47272,46.4,31129,3539,2266,13526,469,859,1377,1154,223,1279,1141,138,1719,1417,302,1804,1675,129,18.648,9.818,6.351
53063,Washington,Spokane County,490764,52159,37.4,331607,61222,36126,121774,5204,8580,24051,19744,4307,24229,21851,2378,30148,23932,6216,31495,27693,3802,29.356,11.319,7.046
53043,Washington,Lincoln County,10344,49460,48.6,7515,1168,553,3487,121,169,264,188,76,285,219,66,447,423,24,393,382,11,22.901,8.317,4.847
53007,Washington,Chelan County,75138,54975,39.9,50640,7907,5389,18007,792,1206,3349,2525,824,3046,2389,657,4040,2941,1099,4141,3341,800,26.256,11.096,6.697
53031,Washington,Jefferson County,30524,51842,57.1,25034,5795,4205,10211,442,884,785,563,222,609,532,77,1008,834,174,1089,862,227,39.946,12.986,8.657
53035,Washington,Kitsap County,258903,68336,39.1,178186,36819,19833,67077,2822,5440,10351,8344,2007,10684,9576,1108,13695,11481,2214,14045,12568,1477,31.794,12.317,8.11
53033,Washington,King County,2118119,83571,37.2,1500090,460158,294667,488554,22429,39613,94888,81456,13432,93043,82731,10312,169159,145966,23193,160257,143760,16497,50.319,12.699,8.108
53049,Washington,Pacific County,20940,39895,52.7,16091,1746,997,6701,246,486,754,483,271,486,464,22,811,546,265,786,746,40,17.047,10.924,7.253
53051,Washington,Pend Oreille County,13066,49184,50.2,9768,1346,616,4388,67,276,336,272,64,340,265,75,509,388,121,506,407,99,20.086,7.817,6.29
53055,Washington,San Juan County,16221,60271,55.7,13148,3683,2665,5718,250,595,399,309,90,394,338,56,526,394,132,588,446,142,48.281,14.778,10.406
53059,Washington,Skamania County,11498,53606,46,8429,1151,808,3265,171,224,371,313,58,354,345,9,529,454,75,516,434,82,23.241,12.098,6.861
53075,Washington,Whitman County,47794,41574,24.5,23365,5727,5584,7856,210,275,8090,7336,754,7380,6923,457,3042,2674,368,2338,2196,142,48.41,6.174,3.501
53077,Washington,Yakima County,248279,47470,32.7,149420,14665,9131,51225,2065,3524,12238,7897,4341,11442,8487,2955,13826,9199,4627,14350,10200,4150,15.926,10.911,6.879
53009,Washington,Clallam County,73439,48002,50.5,55540,8252,5658,22480,806,1832,2745,2132,613,2216,1832,384,3346,2681,665,3125,2529,596,25.045,11.735,8.149
53015,Washington,Cowlitz County,103590,49804,41.4,71602,6908,4599,26975,1158,1890,4075,3428,647,4081,3608,473,5283,4255,1028,5257,4652,605,16.071,11.299,7.006
53019,Washington,Ferry County,7568,41081,49,5560,620,352,2152,69,133,304,256,48,229,182,47,263,171,92,255,222,33,17.482,9.387,6.18
53039,Washington,Klickitat County,21172,51258,45.9,15380,2725,1247,5572,118,498,710,575,135,761,594,167,882,683,199,959,828,131,25.826,11.055,8.938
53041,Washington,Lewis County,76012,46387,42.8,53373,5159,3045,20666,970,1350,2952,2260,692,2758,2419,339,3984,3031,953,3803,3216,587,15.371,11.226,6.532
53017,Washington,Douglas County,40585,55805,37.3,26449,3293,1541,10337,327,672,1765,1224,541,1560,1158,402,2294,1644,650,2100,1591,509,18.277,9.664,6.501
53027,Washington,Grays Harbor County,71454,45483,43.5,51198,5191,2568,18547,918,1277,2869,2185,684,2478,2142,336,3371,2334,1037,3394,2708,686,15.155,11.835,6.885
53029,Washington,Island County,80323,61516,44.1,58111,11987,6853,23180,1083,2197,2404,1805,599,2631,2443,188,3602,2909,693,3960,3596,364,32.421,14.15,9.478
53053,Washington,Pierce County,845193,63881,36,563258,96186,49983,191613,9407,14695,38244,31189,7055,38110,33318,4792,52168,42052,10116,55320,48300,7020,25.951,12.578,7.669
53069,Washington,Wahkiakum County,4105,49508,53.3,3119,283,251,1477,52,60,184,138,46,100,100,0,139,94,45,101,85,16,17.121,7.583,4.062
53021,Washington,Franklin County,89124,60275,29.9,51123,5431,2898,17835,583,944,4712,2995,1717,3837,2739,1098,5625,4064,1561,6016,4278,1738,16.292,8.562,5.293
53071,Washington,Walla Walla County,59862,52630,37.3,39135,7069,4330,14453,572,792,3656,2810,846,3413,2795,618,2809,2052,757,2793,2337,456,29.127,9.437,5.48
53025,Washington,Grant County,93420,52382,32.6,56185,6140,3229,18928,573,1099,4787,3093,1694,4131,3309,822,5624,3910,1714,5337,3816,1521,16.675,8.833,5.806
53073,Washington,Whatcom County,212738,56419,36.9,139327,31019,16131,51560,2414,4082,14927,12794,2133,15780,14142,1638,12181,9844,2337,11464,10018,1446,33.841,12.599,7.917
53061,Washington,Snohomish County,771904,78020,37.8,530117,114528,51613,189431,8099,14900,32559,28260,4299,31689,28249,3440,49433,41343,8090,48648,42946,5702,31.34,12.141,7.866
54033,West Virginia,Harrison County,68438,48315,42,48497,6986,3981,20513,271,625,2490,1953,537,2606,2260,346,3891,3020,871,3801,3400,401,22.614,4.368,3.047
54069,West Virginia,Ohio County,42906,45777,43.5,30178,5687,3616,12382,108,269,2214,1821,393,2137,1848,289,2054,1724,330,2047,1750,297,30.827,3.045,2.173
54085,West Virginia,Ritchie County,10005,41497,45.8,7291,363,315,3007,22,70,342,219,123,348,277,71,452,309,143,428,302,126,9.299,3.06,2.328
54013,West Virginia,Calhoun County,7450,36279,47.9,5555,430,161,2355,20,67,203,176,27,204,174,30,357,327,30,348,346,2,10.639,3.694,2.845
54065,West Virginia,Morgan County,17510,46346,47,12966,1306,1025,5776,253,545,504,388,116,694,431,263,787,671,116,749,681,68,17.978,13.816,9.436
54043,West Virginia,Lincoln County,21241,37075,42.7,14952,940,395,6221,68,182,823,643,180,774,519,255,1044,795,249,1072,916,156,8.929,4.019,2.926
54081,West Virginia,Raleigh County,77097,42386,42,55132,6721,3519,22736,398,887,2988,2160,828,2708,2339,369,3769,2769,1000,3979,3485,494,18.574,5.652,3.901
54007,West Virginia,Braxton County,14345,41266,44.9,10376,1117,516,4267,86,170,465,387,78,378,332,46,675,508,167,678,547,131,15.738,6,3.984
54079,West Virginia,Putnam County,56644,59113,41.6,39835,5997,3933,17667,210,655,2222,1956,266,1894,1633,261,2885,2500,385,2895,2521,374,24.928,4.896,3.707
54001,West Virginia,Barbour County,16790,37516,40.9,11319,1102,633,4508,71,188,942,875,67,957,929,28,695,577,118,848,751,97,15.328,5.745,4.17
54005,West Virginia,Boone County,23236,37955,42.5,16442,739,555,7148,133,300,845,655,190,803,748,55,1087,911,176,1073,968,105,7.87,6.058,4.197
54047,West Virginia,McDowell County,19707,25595,44,14437,437,270,6117,108,141,690,361,329,605,417,188,620,497,123,915,715,200,4.897,4.071,2.305
54099,West Virginia,Wayne County,41063,38905,43.3,29210,2216,1583,12182,104,514,1754,1475,279,1526,1396,130,1761,1408,353,1974,1504,470,13.006,5.073,4.219
54109,West Virginia,Wyoming County,22130,37644,43.8,15859,861,619,7477,135,348,684,600,84,882,717,165,1066,949,117,980,943,37,9.332,6.46,4.654
54035,West Virginia,Jackson County,29123,41731,43,20516,2089,1243,8643,270,246,1258,1123,135,1087,910,177,1397,1015,382,1292,1239,53,16.241,5.97,2.846
54055,West Virginia,Mercer County,60963,37763,42.7,43084,5646,2895,17959,329,748,2785,2026,759,2756,2272,484,2961,2359,602,3204,2850,354,19.824,5.997,4.165
54097,West Virginia,Upshur County,24604,39434,41.8,16733,1805,1218,6962,104,269,1541,1184,357,1238,1107,131,1054,824,230,1279,1118,161,18.066,5.358,3.864
54101,West Virginia,Webster County,8637,33390,46.2,6268,351,307,2633,27,95,352,256,96,327,278,49,341,321,20,337,329,8,10.498,4.633,3.608
54003,West Virginia,Berkeley County,111610,59480,38.8,76160,10250,5505,31348,1231,2029,4576,3987,589,4315,3606,709,6229,5394,835,7029,6281,748,20.687,10.399,6.473
54019,West Virginia,Fayette County,44602,39297,43.3,32026,3281,1423,13889,383,598,1723,1148,575,1635,1302,333,2244,1606,638,1998,1749,249,14.688,7.063,4.306
54023,West Virginia,Grant County,11673,40093,46.3,8507,720,512,3486,39,158,477,396,81,378,302,76,489,354,135,525,462,63,14.482,5.651,4.532
54027,West Virginia,Hampshire County,23412,36575,45.4,16994,1322,821,6244,179,328,899,743,156,732,614,118,1044,812,232,972,874,98,12.61,8.12,5.253
54089,West Virginia,Summers County,13210,35218,47.3,10183,847,630,4055,47,165,447,368,79,354,282,72,505,418,87,622,609,13,14.505,5.228,4.069
54009,West Virginia,Brooke County,23067,48835,46.2,16609,2070,1238,7440,85,153,1087,910,177,957,911,46,946,748,198,980,868,112,19.917,3.199,2.056
54017,West Virginia,Doddridge County,8570,44437,44.5,6240,602,328,2237,49,127,451,366,85,216,211,5,283,258,25,341,272,69,14.904,7.868,5.677
54025,West Virginia,Greenbrier County,35523,40483,45.4,26071,3298,1984,11077,281,573,1295,1105,190,1279,1089,190,1682,1212,470,1822,1538,284,20.26,7.71,5.173
54031,West Virginia,Hardy County,13812,42573,44.9,10109,934,525,4051,134,148,439,381,58,475,394,81,679,525,154,759,542,217,14.433,6.961,3.653
54049,West Virginia,Marion County,56575,48158,41.3,38786,5352,3187,17074,311,505,3123,2709,414,3053,2723,330,2910,2332,578,2934,2670,264,22.016,4.779,2.958
54057,West Virginia,Mineral County,27421,40749,43.5,19276,1436,1010,7530,151,149,1311,1013,298,1229,897,332,1339,1070,269,1189,1053,136,12.689,3.984,1.979
54059,West Virginia,Mingo County,25150,31227,42.1,17789,927,717,8055,107,294,972,754,218,938,842,96,1236,969,267,1379,1191,188,9.242,4.978,3.65
54029,West Virginia,Hancock County,29921,43634,46.1,22063,2602,1350,9149,250,327,1043,910,133,953,874,79,1382,1016,366,1353,1209,144,17.912,6.307,3.574
54041,West Virginia,Lewis County,16371,39793,42.8,11745,1061,514,4634,39,214,596,416,180,580,411,169,848,616,232,893,675,218,13.41,5.46,4.618
54051,West Virginia,Marshall County,32006,42473,44.9,23157,2546,1408,9924,150,258,1374,1060,314,1163,1046,117,1372,1116,256,1508,1331,177,17.075,4.111,2.6
54067,West Virginia,Nicholas County,25496,39037,44.9,18576,1632,1097,8474,204,230,1148,825,323,892,714,178,1021,905,116,1332,1149,183,14.691,5.122,2.714
54075,West Virginia,Pocahontas County,8574,37111,48.6,6546,699,464,2980,124,73,218,153,65,246,137,109,437,214,223,366,284,82,17.767,6.611,2.45
54093,West Virginia,Tucker County,7035,43294,48.1,5257,446,332,2388,46,81,235,197,38,277,234,43,312,271,41,302,264,38,14.799,5.318,3.392
54095,West Virginia,Tyler County,8949,40902,46.5,6516,613,270,2765,54,66,285,212,73,334,267,67,398,235,163,371,248,123,13.551,4.34,2.387
54083,West Virginia,Randolph County,29152,40094,43.1,21070,1998,1727,8235,207,317,1259,1003,256,1141,861,280,1320,1029,291,1360,1068,292,17.679,6.363,3.849
54087,West Virginia,Roane County,14348,37931,44.8,10272,719,453,4618,98,186,457,383,74,431,373,58,633,489,144,624,512,112,11.41,6.15,4.028
54091,West Virginia,Taylor County,16977,45916,43.2,12289,1632,649,5197,76,186,546,400,146,626,575,51,943,703,240,807,703,104,18.561,5.041,3.579
54105,West Virginia,Wirt County,5800,38936,43.4,4064,153,150,2025,6,55,202,186,16,209,136,73,209,173,36,274,233,41,7.456,3.012,2.716
54107,West Virginia,Wood County,86016,45537,43,61058,8074,5043,25687,683,1001,3385,2716,669,3301,2828,473,4205,3244,961,4572,3958,614,21.483,6.556,3.897
54015,West Virginia,Clay County,8901,34242,43.6,6236,316,244,2739,82,107,359,283,76,210,196,14,362,251,111,422,378,44,8.98,6.9,3.907
54021,West Virginia,Gilmer County,8305,37175,38,5695,517,396,2008,42,53,723,689,34,449,381,68,309,213,96,288,211,77,16.032,4.731,2.639
54053,West Virginia,Mason County,27000,38977,44,19448,1534,610,8586,168,441,909,843,66,865,738,127,1253,1019,234,1254,1100,154,11.024,7.093,5.136
54061,West Virginia,Monongalia County,103715,49624,30.9,63582,13055,12251,22149,427,803,11672,10788,884,10529,9866,663,8335,6561,1774,7044,6274,770,39.801,5.553,3.625
54063,West Virginia,Monroe County,13517,36684,47.7,9979,923,520,4672,42,181,484,407,77,461,353,108,569,369,200,559,444,115,14.46,4.773,3.874
54073,West Virginia,Pleasants County,7527,45152,43.4,5439,416,332,2340,43,109,302,260,42,267,219,48,393,315,78,334,313,21,13.753,6.496,4.658
54103,West Virginia,Wetzel County,15793,40694,45.9,11338,791,549,4716,32,93,573,455,118,678,525,153,711,585,126,651,536,115,11.819,2.651,1.972
54011,West Virginia,Cabell County,96100,37816,38.3,63885,8961,7470,24523,645,946,6605,5214,1391,6504,5583,921,5243,4035,1208,5043,4597,446,25.72,6.488,3.858
54037,West Virginia,Jefferson County,55673,72526,40.2,38100,7161,4474,15420,503,719,2264,1946,318,2451,2263,188,2819,2321,498,2883,2690,193,30.538,7.925,4.663
54039,West Virginia,Kanawha County,187827,46859,43.1,134994,19988,14174,55469,1127,1831,7300,5811,1489,7317,6384,933,10054,7974,2080,10442,9055,1387,25.306,5.333,3.301
54045,West Virginia,Logan County,34428,37859,43,24813,1304,847,10337,132,476,1287,1014,273,1238,1096,142,1642,1079,563,1613,1329,284,8.669,5.882,4.605
54071,West Virginia,Pendleton County,7138,39554,49.9,5351,354,390,2421,70,100,320,238,82,210,190,20,235,184,51,271,221,50,13.904,7.022,4.131
54077,West Virginia,Preston County,33760,46673,42.6,24792,2096,1620,10160,257,342,1245,1040,205,1141,1033,108,1571,1211,360,1653,1357,296,14.989,5.896,3.366
55105,Wisconsin,Rock County,161226,53410,39.3,108792,15410,7900,44273,1507,2674,7034,5716,1318,6550,5801,749,8555,6942,1613,9228,8202,1026,21.426,9.444,6.04
55119,Wisconsin,Taylor County,20344,49821,43.4,14058,1403,627,6738,212,402,754,529,225,590,496,94,917,755,162,922,828,94,14.44,9.112,5.966
55137,Wisconsin,Waushara County,24170,48412,48.8,18133,1756,992,8030,268,613,807,585,222,684,564,120,881,721,160,900,814,86,15.155,10.971,7.634
55001,Wisconsin,Adams County,20111,44003,52.6,15993,1293,711,6916,279,534,523,473,50,434,389,45,729,571,158,649,560,89,12.53,11.755,7.721
55007,Wisconsin,Bayfield County,15004,50110,51.6,11439,2248,1302,5726,169,345,389,343,46,409,350,59,583,501,82,558,504,54,31.034,8.977,6.025
55065,Wisconsin,Lafayette County,16755,55859,41.6,11354,1375,659,5085,158,318,620,458,162,529,435,94,906,758,148,840,745,95,17.914,9.361,6.254
55081,Wisconsin,Monroe County,45303,56479,39.5,30483,4181,1754,12472,331,673,1711,1309,402,1641,1423,218,2207,1859,348,2365,2061,304,19.47,8.05,5.396
55093,Wisconsin,Pierce County,41226,66772,36.6,25871,4856,2314,11141,343,573,2704,2489,215,3365,3103,262,2174,1778,396,1991,1816,175,27.714,8.222,5.143
55141,Wisconsin,Wood County,73427,51603,43.8,52010,6961,4012,23492,592,1055,2636,2272,364,2524,2155,369,3759,3251,508,3805,3612,193,21.098,7.011,4.491
55003,Wisconsin,Ashland County,15779,41505,41.7,10671,1430,887,4455,96,230,767,667,100,653,590,63,773,653,120,733,608,125,21.713,7.318,5.163
55015,Wisconsin,Calumet County,49737,70662,39.8,33454,7158,2396,15628,286,551,1994,1719,275,1663,1580,83,2299,2147,152,2463,2358,105,28.559,5.356,3.526
55037,Wisconsin,Florence County,4354,47827,51.9,3410,420,129,1712,29,102,120,57,63,116,114,2,168,158,10,161,158,3,16.1,7.652,5.958
55055,Wisconsin,Jefferson County,84586,59215,40.1,57551,9538,4188,22806,824,1249,3977,3542,435,3527,3271,256,4313,3667,646,4555,4109,446,23.85,9.09,5.477
55059,Wisconsin,Kenosha County,167886,57269,37.9,111210,18591,9334,41539,1664,2952,8146,6616,1530,7764,6760,1004,9130,7707,1423,9612,8478,1134,25.11,11.112,7.107
55051,Wisconsin,Iron County,5748,39855,53.8,4624,611,280,2246,72,159,150,89,61,159,129,30,216,159,57,178,155,23,19.269,10.285,7.079
55019,Wisconsin,Clark County,34513,49131,37.5,21724,1799,678,9921,338,662,1322,732,590,1254,752,502,1591,1008,583,1479,1092,387,11.402,10.08,6.673
55109,Wisconsin,St. Croix County,87142,77768,38.3,58155,13963,5834,25266,933,1330,3156,2786,370,3010,2751,259,4348,3932,416,4620,4345,275,34.042,8.957,5.264
55083,Wisconsin,Oconto County,37465,55762,46.3,27408,3268,1345,13027,371,770,1219,1055,164,1088,1038,50,1660,1446,214,1613,1470,143,16.831,8.759,5.911
55069,Wisconsin,Lincoln County,27994,54203,46.9,20564,2532,1028,9732,330,368,919,800,119,923,800,123,1199,996,203,1117,1050,67,17.312,7.172,3.781
55135,Wisconsin,Waupaca County,51651,54071,44.9,37085,5022,1844,16047,429,810,1866,1609,257,1802,1614,188,2423,1937,486,2284,1997,287,18.514,7.721,5.048
55005,Wisconsin,Barron County,45358,49257,44.2,32218,4091,2176,14247,595,742,1611,1322,289,1561,1401,160,2310,1888,422,2136,1944,192,19.452,9.384,5.208
55113,Wisconsin,Sawyer County,16384,43565,49.7,12087,1713,952,5528,211,299,560,416,144,471,410,61,575,404,171,616,533,83,22.048,9.226,5.409
55047,Wisconsin,Green Lake County,18745,50276,45.5,13275,1729,731,5884,179,350,605,527,78,573,417,156,842,723,119,802,679,123,18.531,8.99,5.948
55099,Wisconsin,Price County,13566,45680,51.3,10409,1305,462,5138,153,327,475,415,60,392,329,63,479,439,40,430,379,51,16.976,9.342,6.364
55077,Wisconsin,Marquette County,15164,49052,49.4,11302,1114,426,5171,231,365,458,321,137,378,333,45,625,501,124,619,554,65,13.626,11.526,7.059
55075,Wisconsin,Marinette County,40712,44958,47.7,29941,3149,1277,13801,370,779,1517,1308,209,1347,1133,214,1902,1520,382,1659,1511,148,14.782,8.325,5.645
55079,Wisconsin,Milwaukee County,956586,46784,34.6,627652,121110,67997,189686,7477,15549,48465,38279,10186,50057,43677,6380,66523,53037,13486,71083,62954,8129,30.129,12.139,8.197
55101,Wisconsin,Racine County,195101,58334,40.1,132530,21610,10778,52188,1967,3164,7971,6803,1168,7172,6418,754,9609,7846,1763,10603,9716,887,24.438,9.832,6.063
55139,Wisconsin,Winnebago County,169540,55128,38,113634,22213,8838,45027,1365,2250,9723,8664,1059,9984,9365,619,9637,8465,1172,9319,8607,712,27.325,8.029,4.997
55033,Wisconsin,Dunn County,44260,54605,34.2,26879,4754,2682,11405,370,616,3926,3527,399,3638,3223,415,2376,2002,374,2230,2011,219,27.665,8.645,5.401
55041,Wisconsin,Forest County,9035,43356,46.2,6433,563,373,3025,159,217,363,222,141,320,224,96,391,294,97,392,333,59,14.55,12.43,7.174
55045,Wisconsin,Green County,36869,60609,42.8,25804,4091,1885,11027,329,672,1270,1149,121,1230,1078,152,1800,1609,191,1821,1664,157,23.159,9.078,6.094
55043,Wisconsin,Grant County,51742,50522,35.6,31727,4327,2500,13448,341,803,4949,4427,522,3412,2932,480,2591,2240,351,2185,1998,187,21.518,8.507,5.971
55107,Wisconsin,Rusk County,14211,41930,48.6,10268,1022,495,4877,242,329,470,323,147,403,246,157,533,432,101,537,468,69,14.774,11.708,6.746
55115,Wisconsin,Shawano County,41136,51751,44.9,29299,2945,1684,12997,370,671,1507,1195,312,1309,1056,253,1858,1568,290,1875,1678,197,15.799,8.01,5.163
55117,Wisconsin,Sheboygan County,115094,56114,41.3,79451,13283,5653,33085,1015,1589,4482,3772,710,4505,4076,429,6040,5142,898,5556,5071,485,23.834,7.871,4.803
55067,Wisconsin,Langlade County,19190,44122,47.6,14098,1516,827,6632,249,403,683,495,188,549,433,116,857,746,111,779,658,121,16.619,9.831,6.077
55078,Wisconsin,Menominee County,4506,38080,31.4,2562,257,150,898,0,49,224,109,115,213,116,97,179,75,104,237,173,64,15.886,5.457,5.457
55087,Wisconsin,Outagamie County,183288,61523,37.9,122988,24780,10055,50989,1450,2266,8144,7010,1134,7878,7091,787,11238,10010,1228,10571,9734,837,28.324,7.288,4.444
55123,Wisconsin,Vernon County,30378,49996,42.3,20379,2881,1529,9332,271,699,989,639,350,991,755,236,1269,961,308,1287,1013,274,21.64,10.394,7.49
55011,Wisconsin,Buffalo County,13243,54753,45.7,9528,1159,551,4308,121,226,465,410,55,408,361,47,639,583,56,596,565,31,17.947,8.055,5.246
55021,Wisconsin,Columbia County,56790,63293,42.4,39986,6391,2648,17241,574,949,2109,1721,388,1926,1668,258,2819,2350,469,2766,2583,183,22.605,8.834,5.504
55061,Wisconsin,Kewaunee County,20378,60320,43.9,14427,2024,607,6437,209,344,763,610,153,599,540,59,974,893,81,929,865,64,18.237,8.591,5.344
55063,Wisconsin,La Crosse County,117582,54127,35.5,74487,15650,8950,29983,795,1332,8507,7531,976,10102,9405,697,6659,5789,870,6190,5747,443,33.026,7.094,4.443
55009,Wisconsin,Brown County,258004,56775,37,171208,35638,14949,67264,1753,3393,11230,9347,1883,11977,10595,1382,15790,13560,2230,15612,13831,1781,29.547,7.65,5.044
55035,Wisconsin,Eau Claire County,102388,52178,34.3,64097,12686,6750,25473,721,1366,7992,6889,1103,8726,7851,875,6198,5126,1072,6120,5419,701,30.323,8.193,5.363
55073,Wisconsin,Marathon County,135293,56509,40.7,92910,15345,7430,39911,1141,2055,5503,4642,861,5087,4321,766,7486,6349,1137,7246,6589,657,24.513,8.008,5.149
55085,Wisconsin,Oneida County,35352,52945,50.6,27032,4830,2608,12547,484,835,1140,914,226,1086,1001,85,1448,1237,211,1398,1312,86,27.516,10.512,6.655
55095,Wisconsin,Polk County,43328,53551,44.8,30872,4256,1872,14256,583,1099,1466,1214,252,1449,1239,210,1961,1665,296,1922,1702,220,19.85,11.799,7.709
55121,Wisconsin,Trempealeau County,29510,54009,40.5,20076,2776,1171,8578,247,432,1111,860,251,1060,926,134,1435,1222,213,1427,1270,157,19.66,7.916,5.036
55129,Wisconsin,Washburn County,15638,46592,50.4,11719,1755,826,5602,189,427,397,333,64,417,340,77,603,488,115,639,586,53,22.024,10.996,7.622
55133,Wisconsin,Waukesha County,396731,81140,43.1,277757,78511,40693,119721,3780,6461,14796,13585,1211,14359,13759,600,18682,16852,1830,18648,17619,1029,42.917,8.554,5.397
55027,Wisconsin,Dodge County,87833,56038,42.4,63011,7115,3037,23913,939,1316,3553,3256,297,2749,2343,406,4613,3935,678,4075,3864,211,16.111,9.43,5.503
55127,Wisconsin,Walworth County,102917,58401,39.4,67369,12204,7006,27537,1193,2205,6443,5538,905,6025,5536,489,4939,4014,925,4852,4260,592,28.515,12.34,8.007
55125,Wisconsin,Vilas County,21465,42720,53.4,16692,2969,1555,8225,330,749,635,501,134,491,427,64,793,573,220,725,642,83,27.103,13.119,9.106
55023,Wisconsin,Crawford County,16313,47331,45.7,11637,1321,634,5033,136,262,596,499,97,486,439,47,668,564,104,698,605,93,16.8,7.908,5.206
55057,Wisconsin,Juneau County,26427,48817,45.2,19276,1821,741,7819,310,545,950,733,217,732,635,97,1169,961,208,1142,1043,99,13.291,10.935,6.97
55071,Wisconsin,Manitowoc County,79680,51053,44.5,56905,7963,3225,25605,569,1310,2833,2355,478,2683,2528,155,4262,3779,483,3654,3393,261,19.661,7.338,5.116
55111,Wisconsin,Sauk County,63340,54447,41.3,44014,6924,3397,17642,469,1192,2271,1932,339,2248,1835,413,3526,2849,677,3276,2860,416,23.449,9.415,6.757
55131,Wisconsin,Washington County,133967,73021,42.6,93734,20316,7526,41682,1278,2327,4850,4473,377,4409,3990,419,6538,5866,672,6412,6153,259,29.703,8.649,5.583
55013,Wisconsin,Burnett County,15239,45891,52.1,11634,1447,710,5884,269,477,314,283,31,409,380,29,611,477,134,549,512,37,18.54,12.678,8.107
55017,Wisconsin,Chippewa County,63445,55240,41.2,44465,6361,2625,18230,524,797,2204,1863,341,2086,1844,242,3378,2684,694,3210,2887,323,20.209,7.246,4.372
55025,Wisconsin,Dane County,522837,67631,34.8,341196,102061,68513,126397,4327,6182,35932,33054,2878,35397,33044,2353,37444,33455,3989,35326,32998,2328,49.993,8.314,4.891
55029,Wisconsin,Door County,27443,56494,52.3,21378,4399,2602,10301,445,694,859,779,80,728,650,78,1104,974,130,1102,1008,94,32.749,11.057,6.737
55031,Wisconsin,Douglas County,43503,50730,41.3,30724,5065,2276,12579,399,764,1847,1633,214,2021,1803,218,2486,2184,302,2489,2099,390,23.893,9.246,6.074
55039,Wisconsin,Fond du Lac County,102082,57798,41.2,70774,11234,4988,29466,744,1447,4214,3803,411,4246,3832,414,5412,4929,483,5159,4740,419,22.921,7.436,4.911
55053,Wisconsin,Jackson County,20531,51108,42.1,14491,1288,717,6074,217,371,784,599,185,566,472,94,978,767,211,956,763,193,13.836,9.681,6.108
55049,Wisconsin,Iowa County,23576,60017,42.5,16481,2704,1326,7270,221,468,812,621,191,768,674,94,1160,1038,122,1149,1108,41,24.452,9.477,6.437
55091,Wisconsin,Pepin County,7282,51470,45.8,5195,669,323,2440,60,137,237,217,20,219,181,38,307,235,72,327,286,41,19.095,8.074,5.615
55089,Wisconsin,Ozaukee County,87817,80526,43.9,60769,18163,10837,26368,861,1740,3774,3481,293,3285,3066,219,3632,3296,336,3732,3467,265,47.722,9.864,6.599
55097,Wisconsin,Portage County,70371,54620,36.6,44737,9640,4440,19271,515,990,5708,5137,571,5439,5154,285,3773,3221,552,3577,3226,351,31.473,7.81,5.137
55103,Wisconsin,Richland County,17626,48234,44.8,12310,1460,851,5614,238,339,732,581,151,609,486,123,745,652,93,756,704,52,18.773,10.278,6.038
56005,Wyoming,Campbell County,48116,80178,33.2,30465,4266,1374,12575,318,788,2147,1787,360,2114,1756,358,3491,3098,393,3412,2895,517,18.513,8.795,6.266
56023,Wyoming,Lincoln County,18791,63756,39.1,12453,1836,718,5539,145,201,514,392,122,524,368,156,951,581,370,958,778,180,20.509,6.247,3.629
56019,Wyoming,Johnson County,8562,52415,45,6063,1098,526,2718,67,175,295,229,66,212,206,6,318,266,52,391,232,159,26.785,8.904,6.439
56025,Wyoming,Natrona County,81023,59400,36.3,54380,8086,4316,21976,584,1116,3632,2482,1150,3647,2885,762,5583,4142,1441,5275,4265,1010,22.806,7.736,5.078
56021,Wyoming,Laramie County,97031,62879,36.8,65206,11648,7047,26650,816,1272,4308,3462,846,3897,3101,796,6166,4797,1369,6071,4989,1082,28.671,7.835,4.773
56009,Wyoming,Converse County,14166,62776,40,9527,1173,557,4123,142,188,537,434,103,416,329,87,818,637,181,782,647,135,18.159,8.004,4.56
56027,Wyoming,Niobrara County,2479,36793,40.4,1766,251,73,703,21,52,109,97,12,93,73,20,101,101,0,111,111,0,18.347,10.384,7.397
56039,Wyoming,Teton County,22923,80049,39,17008,6407,2798,5142,232,320,852,687,165,756,659,97,2279,1576,703,1860,1684,176,54.122,10.735,6.223
56037,Wyoming,Sweetwater County,44527,71083,34,28393,4348,1958,12001,128,364,2331,1815,516,2061,1529,532,3008,2402,606,2869,2241,628,22.21,4.1,3.033
56031,Wyoming,Platte County,8703,47380,46.7,6286,920,503,2856,28,77,239,225,14,268,181,87,511,320,191,314,282,32,22.638,3.676,2.696
56033,Wyoming,Sheridan County,29964,56455,42.1,21072,3861,2733,9001,192,737,1141,727,414,1166,974,192,1477,1170,307,1595,1294,301,31.293,10.321,8.188
56003,Wyoming,Big Horn County,11920,51716,41.2,8030,1122,421,3255,59,191,528,374,154,361,268,93,477,306,171,584,439,145,19.215,7.68,5.868
56011,Wyoming,Crook County,7347,66944,42.2,5109,724,336,2388,42,68,213,97,116,202,152,50,437,360,77,383,333,50,20.748,4.606,2.848
56029,Wyoming,Park County,29276,60828,44.2,20668,3959,2702,8534,297,318,1220,816,404,1144,1051,93,1542,1247,295,1579,1211,368,32.229,7.206,3.726
56001,Wyoming,Albany County,37944,45816,27.1,20905,5919,4485,7940,208,441,5778,5213,565,5175,4728,447,3026,2536,490,2161,1950,211,49.768,8.174,5.554
56007,Wyoming,Carbon County,15689,57644,38.2,10644,1607,616,4390,90,249,612,448,164,534,427,107,926,774,152,817,643,174,20.885,7.722,5.672
56015,Wyoming,Goshen County,13479,48422,43.7,9449,1442,859,4050,76,321,619,393,226,565,442,123,709,605,104,546,455,91,24.352,9.802,7.926
56041,Wyoming,Uinta County,20758,54672,35.1,12978,1548,711,5556,144,158,888,475,413,671,620,51,1053,770,283,1268,1025,243,17.406,5.436,2.844
56043,Wyoming,Washakie County,8253,51362,43.4,5705,876,322,2657,36,167,246,158,88,238,121,117,405,308,97,370,302,68,20.999,7.64,6.285
56017,Wyoming,Hot Springs County,4741,48403,49.7,3604,478,299,1727,34,83,67,40,27,65,59,6,245,209,36,208,168,40,21.559,6.775,4.806
56013,Wyoming,Fremont County,40354,55013,38.3,26781,4158,2073,10699,433,419,1599,1018,581,1605,996,609,2200,1591,609,2207,1592,615,23.266,7.963,3.916
56035,Wyoming,Sublette County,10037,84911,37.5,7051,1354,439,2419,69,39,246,243,3,140,138,2,659,606,53,444,340,104,25.429,4.465,1.612
56045,Wyoming,Weston County,7117,59605,42.2,5074,717,290,2437,46,124,285,250,35,264,173,91,395,287,108,292,209,83,19.846,6.976,5.088
